babeqgokise - babeqgokise - no corrections
yadniswe - yandiswe 
inguMkhululi - inguMkhululi - no corrections
ledlula - ledlula - no corrections
thina - thina - no corrections
eyayizithokozisa - eyayizithokozisa - no corrections
kuyinkosi - kuyinkosi - no corrections
ziyatshengisa - ziyatshengisa - no corrections
okuyinoveli - okuyinoveli - no corrections
imbokodwe - imbokodwe - no corrections
nalowo - nalowo - no corrections
nkunzi - nkunzi - no corrections
wasemsusa - wasemsusa - no corrections
zifike - zifike - no corrections
ayiqondanga - ayiqondanga - no corrections
ngamaNgisi - ngamaNgisi - no corrections
lingadluliselwanga - lingadluliselwanga - no corrections
athola - athola - no corrections
zokubusa - zokubusa - no corrections
wayekwazi - wayekwazi - no corrections
esedazuluka - esedazuluka - no corrections
abazithandanga - abazithandanga - no corrections
wumthetho - wumthetho - no corrections
kathathu - kathathu - no corrections
wayenokuwabuka - wayenokuwabuka - no corrections
izobuye - izobuye - no corrections
bavukwe - bavukwe - no corrections
nepolitiki - nepolitiki - no corrections
uSobantu - uSobantu - no corrections
uMntwana - uMntwana - no corrections
ngokwemiyalelo - ngokwemiyalelo - no corrections
kukaMbuyazi - kukaMbuyazi - no corrections
eyokwenanyelwa - eyokwenanyelwa - no corrections
wabe - wabe - no corrections
ubahlabe - ubahlabe - no corrections
kokuthatha - kokuthatha - no corrections
okusekhona - okusekhona - no corrections
njengesithakazelo - njengesithakazelo - no corrections
bunkondlo - bunkondlo - no corrections
ayesaba - ayesaba - no corrections
ebukhosini - ebukhosini - no corrections
eduze - eduze - no corrections
angabulali - angabulali - no corrections
ngiphumelele - ngiphumelele - no corrections
esichitha - esichitha - no corrections
kwesigodlo - kwesigodlo - no corrections
kazange - kazange - no corrections
olakeni - olakeni - no corrections
ehhovisi - ehhovisi - no corrections
umlomo - umlomo - no corrections
zazihaywa - zazihaywa - no corrections
yancama - yancama - no corrections
