owaunomqambi - owawunomqambi
ungasagcwli - ungasagcwali
wobukhsi - wobukhosi
Isaasa - Isasasa
zkubuka - zokubuka
nempio - nempilo
ababesiwa - ababesizwa
sase - esase
nendawo - ngendawo
iifundo - isifundo
zigqamia - zigqamisa
hlakaniphile - ehlakaniphile
zanamalala - zanyamalala
iyiqiniso - ziyiqiniso
nessekelo - nesisekelo
sinakho - esinakho
aduma - waduma
smabala - simabala
nenliziyo - nenhliziyo
kwazetusa - kwazethusa
emehweni - emehlweni
nmibono - nemibono
ekulotshwni - ekulotshweni
okuqhakambisa - wokuqhakambisa
ezihekile - ezibhekile
USithai - USithayi
kwauyiyona - kwakuyiyona
kasiqaphelisie - kasiqaphelisise
elungileo - elungileyo
Kunezichazamazi - Kunezichazamazwi
ubyisa - ubuyisa
Umlambongweya - Umlambongwenya
abona - wabona
lomlndo - lomlando
gamaBhunu - ngamaBhunu
Kungthathwa - Kungathathwa
momo - mgomo
azelusa - wazelusa
beliye - belinye
eshlela - esehlela
siuthola - sikuthola
aba - baba
ayemningi - ayemaningi
elaisihloko - elalisihloko
outhi - oluthi
nocwningo - nocwaningo
neibongo - nezibongo
gokuzalana - ngokuzalana
kungacai - kungacaci
bao - babo
befka - befika
anhlanhlate - anhlanhlathe
kezwe - kwezwe
ekwakhiwei - ekwakhiweni
Waa - Wafa
eona - ebona
zatshea - zatshela
itshawa - itshalwa
waseNatai - waseNatali
waabela - wasabela
yiveza - Uyiveza
illa - ilula
kufudiswa - kufundiswa
abela - sabela
nokuhambisana - ngokuhambisana
eihloko - esihloko
ukthola - ukuthola
weusa - welusa
sabhlula - sabehlula
zizayo - ezizayo
ngkwesibonelo - ngokwesibonelo
yayihathwa - yayithathwa
abaabhali - abakabhali
zihoko - zihloko
abaebeyigwaze - abasebeyigwaze
aydla - ayodla
Izindlla - Izindlela
nengcidezi - nengcindezi
zibonsa - zibonisa
iyobonisaa - iyobonisana
asebedule - asebedlule
mne - mane
lmtshele - limtshele
yigma - yigama
ukuzobngelela - ukuzobingelela
esizeni - esizweni
aziniezi - azinikezi
ikwzi - ikwazi
yayigczelele - yayigcizelele
Kwenzea - Kwenzeka
Zebuloni - uZebuloni
okulalwa - okuhlalwa
ababemhlphe - ababemhlophe
waphka - waphika
isqu - isiqu
ueku - uteku
ngobukhoa - ngobukhona
oondele - osondele
oqondee - oqondene
izinkodlo - izinkondlo
bwe - bawe
njengendoana - njengendodana
ngehlendla - ngenhlendla
yimphi - yimuphi
kwakyiphutha - kwakuyiphutha
ebhaa - ebhala
wokulanganisa - wokuhlanganisa
aze - Waze
exoa - exoxa
vezwe - avezwe
wabamhlophe - kwabamhlophe
eselithlile - eselitholile
shlulwe - sehlulwe
abapansi - abaphansi
ngokkhululeka - ngokukhululeka
esezolahlekela - esezolahlekelwa
enqieni - enqineni
noMavumngwane - noMavumengwane
yayinobuele - yayinobubele
njengaasosha - njengamasosha
usze - useze
abulwe - abulawe
ngoMgolwana - ngoMagolwana
esizoqqa - esizoqoqa
ngokulanela - ngokulandela
kuekelwa - kubekelwa
isigeeza - isigedeza
ishluko - isahluko
bamkolwa - bamkholwa
lweifengqo - lwesifengqo
uMthoga - uMthonga
kwamanxsa - kwamanxusa
abuala - abulala
Waibeka - Wazibeka
iZambei - iZambezi
abulae - abulale
ehluwa - ehlulwa
oungamagugu - okungamagugu
zezkhathi - zezikhathi
Bayiwze - Bayiweze
ayibnga - ayibanga
iNgonyaa - iNgonyama
ebambisee - ebambisene
yayilgugu - yayiligugu
eyakhonwa - eyakhonjwa
ayaluza - Bayaluza
wlanda - walanda
kukhlunye - kukhulunye
wayengahulumi - wayengakhulumi
angaali - angasali
eqa - yeqa
iyizwe - niyizwe
zngu - zungu
uNandaana - uNandawana
iigqi - isigqi
olunabumba - olungabumba
umzima - umzimba
ekufikni - ekufikeni
mathahu - mathathu
asNtshonalanga - aseNtshonalanga
ykwaMthethwa - yakwaMthethwa
bhlala - bahlala
kqalwa - kuqalwa
okhluma - okhuluma
nglikhulu - ngelikhulu
abholi - abaholi
nnothile - nanothile
nezwe - ngezwe
ubeela - ubecela
abaentshisekelo - abanentshisekelo
uboakala - ubonakala
eze - neze
ehalamende - ePhalamende
kuhala - kuhlala
Yizna - Yizona
sauka - sasuka
Miingi - Miningi
kubekwe - akubekwe
ayikhohe - ayikhokhe
wacacisleka - wacaciseleka
zie - zibe
babua - babuya
esivivaeni - esivivaneni
zizizwee - zizizwele
esizihenya - esiziqhenya
njalo - enjalo
iimpisi - izimpisi
eyiuka - eyibuka
nokufuda - nokufunda
ngokuchitha - ngokuchithwa
akushoo - akushoyo
abagaza - abagwaza
ihlukaniske - ihlukaniseke
ezinekulumo - ezinenkulumo
yayethulwe - eyayethulwe
wayenamdodana - wayenamadodana
babengenanaba - babengenandaba
inazelo - incazelo
Yie - Yile
bsukuma - basukuma
nobusazwe - nombusazwe
likankaisa - likankamisa
epikiswa - ephikiswa
ekona - ekhona
njenglimi - njengolimi
sandlalela - esandlalela
Okuuke - Okusuke
somchobka - somchoboka
kwaznywa - kwazanywa
engajwyelekile - engajwayelekile
amaisa - amawisa
ezingalandlwa - ezingalandelwa
kubhala - Ukubhala
yiona - yikona
 - ka
phthini - phethini
ubizwa - lubizwa
abambela - yabambela
nguena - nguwena
seuleko - seluleko
ewa - elwa
olushbile - olushubile
UNgubae - UNgubane
ncoma - encoma
esiyinozi - esiyingozi
ayebuyea - ayebuyela
Wanena - Wangena
ungaba - Kungaba
simhlangansa - simhlanganisa
ngeintelezi - ngezintelezi
nnkosazana - nenkosazana
engalokoti - engalokothi
gusaziwayo - ngusaziwayo
nala - ndala
khule - ikhule
ngaphezu - engaphezu
zii - ziyi
ngolii - ngolimi
eyayisekuzingeeni - eyayisekuzingeleni
sikanlunkulu - sikandlunkulu
ibalulekile - Zibalulekile
kugumholi - kungumholi
kupakathi - kuphakathi
izamo - mizamo
uhanganyelwe - uhlanganyelwe
kwauthi - kwakuthi
ezzwe - ezizwe
Lwae - Lwabe
mba - emba
kubuhlugu - kubuhlungu
zaso - zasho
ayibhle - ayibhale
kuyikhona - okuyikhona
wahela - wahlela
yountu - yomuntu
yihlawule - ayihlawule
silwae - silwane
aoyibuza - azoyibuza
seklandule - sekulandule
ekhlwini - ekhulwini
okuibona - okuyibona
nsendlunkulu - nasendlunkulu
nokuihlanganisa - nokuzihlanganisa
samukeeka - samukeleka
isikundla - isikhundla
mvunulo - imvunulo
khona - Ikhona
gokubonga - ngokubonga
ndao - ndawo
kudigeke - kudingeke
ezivule - sezivule
zinmsebenzi - zinomsebenzi
izochba - izochoba
sezvuka - sezivuka
iseduli - isheduli
yafkela - yafikela
kuhe - kuhle
zabaundi - zabafundi
laa - laba
zleyo - zaleyo
eNgoe - eNgome
keze - akeze
aeza - aveza
wahabhali - wabhabhali
nabamhlphe - nabamhlophe
yokukumbula - yokukhumbula
ibuka - ibukwa
wbe - wabe
eyayizohendula - eyayizophendula
ngangkuthi - ngangokuthi
Mthnga - Mthonga
uzolotswa - uzolotshwa
aphle - aphile
bamakhoskazi - bamakhosikazi
uMfumfu - kuMfumfu
waa - wafa
obhalwe - nobhalwe
kwemizao - kwemizamo
elangzelela - elangazelela
enze - benze
nenkollo - nenkolelo
yacela - yacelwa
kngwaqa - kongwaqa
ukdlulisa - ukudlulisa
eblala - ebulala
zosekwedlue - zosekwedlule
emaphephadabeni - emaphephandabeni
nyedwa - noyedwa
aelwa - ayelwa
luzqala - luzoqala
makhulunyaka - amakhulunyaka
isivle - isivele
imthola - Simthola
imblale - imbulale
egaeni - egameni
pela - phela
okase - okwase
izihole - izithole
onguise - onguyise
abaneibindi - abanesibindi
eebakhwelela - esebakhwelela
Udunankulu - UNdunankulu
undlovukayiphikisa - undlovukayiphikiswa
intshiseklo - intshisekelo
kuthaniya - kuMthaniya
ngapambi - ngaphambi
busa - ebusa
byibuka - beyibuka
ayeslele - ayesalele
aambele - abambele
zisho - ezisho
Ntombazi - uNtombazi
lse - lase
bulawa - ebulawa
kuyilunglo - kuyilungelo
wayengowokudauka - wayengowokudabuka
wakwaZuu - wakwaZulu
uNoishada - uNozishada
ludngekile - ludingekile
okweza - okwenza
begabadi - bengabadi
lubkhombise - lubakhombise
wakwSokesimbone - wakwaSokesimbone
zambutho - zamabutho
ayiusa - ayibusa
aqoba - anqoba
juba - ijuba
njengasesahlukeni - njengasesahlukweni
lzo - lazo
wya - waya
ayo - layo
zipi - zimpi
kwakugciwe - kwakugcinwe
ikwazi - zikwazi
wabekana - wabhekana
ebucikwei - ebucikweni
yokqhuba - yokuqhuba
uMahablana - uMahabulana
ekufni - ekufeni
ondunkulu - ondlunkulu
Ingxeye - Ingxenye
Khumalo - uKhumalo
kwabe - okwabe
ohembekile - othembekile
semvumelwno - semvumelwano
akabzanga - akabuzanga
izaa - izaga
ayicashe - yayicashe
AbaeNdlunkulu - AbaseNdlunkulu
wfunga - wafunga
ynduna - yinduna
afike - yafike
zansuu - zansuku
jengesizwe - njengesizwe
ysisusa - yisisusa
siyobnana - siyobonana
Bathela - Batshela
soudla - sokudla
usukela - Kusukela
owahlela - owaholela
nezimfiho - nezimfihlo
Bainikeza - Bayinikeza
sobzwe - sobuzwe
eseenzile - esebenzile
Natali - eNatali
kufuwa - kufunwa
ayezibnela - ayezibonela
agdluzwe - agudluzwe
ukudunyiwa - ukudunyiswa
yayilangazeela - yayilangazelela
okuthntene - okuthintene
Wayee - Wayeke
Wnele - Wanele
nangandlla - nangandlela
ezhlonishwayo - ezihlonishwayo
zokthi - zokuthi
neznhloso - nezinhloso
Ngsikhathi - Ngesikhathi
Umlingisa - Umlingiswa
wagcwla - wagcwala
nza - enza
eminyaeni - eminyakeni
eziwmongo - eziwumongo
ekuqalni - ekuqaleni
oyizibono - oyizibongo
iungiselelwe - ilungiselelwe
uNoyanda - uNonyanda
seslwane - sesilwane
lilugu - lilungu
ynsuku - yansuku
yokubusa - yokubuswa
songa - esonga
nokuqhtshwa - nokuqhutshwa
awukhombisa - yawukhombisa
simo - Isimo
amaphepha - namaphepha
Okufie - Okufike
siusa - sivusa
waele - wavele
abaqhueke - abaqhubeke
yakhalsa - yakhalisa
zingalhluphekeli - zingaluhluphekeli
ezihi - ezithi
Ubunkondo - Ubunkondlo
Ekkhuleni - Ekukhuleni
azphonse - aziphonse
Kwamsza - Kwamsiza
oekuke - osekuke
Khmalo - Khumalo
ayengzwa - ayengezwa
kulugiswe - kulungiswe
njengezihakamiso - njengeziphakamiso
naseizweni - nasesizweni
samnzi - samanzi
njengomntu - njengomuntu
kwaungukusonta - kwakungukusonta
wayiuma - wayivuma
ngocwanino - ngocwaningo
esibayni - esibayeni
ubntu - ubuntu
oMhangana - oMhlangana
gohlelo - ngohlelo
emvei - emveni
babethanda - ababethanda
naambuka - namambuka
idngile - idingile
elithle - elithile
yamautho - yamabutho
uaphila - uyaphila
Sambana - uSambana
kuzokwenzea - kuzokwenzeka
ienze - izenze
izezo - izenzo
esbona - esebona
sawaqoba - sawanqoba
sebeyibulee - sebeyibulele
nni - nini
azbalwa - azibalwa
eyayingzange - eyayingazange
kwemnye - kweminye
abapathi - abaphathi
Banatholakala - Bangatholakala
ayengumakhi - wayengumakhi
oluzokwai - oluzokwazi
ezazikhoba - ezazikhomba
namaggu - namagugu
ozlwa - ozalwa
ombhalo - lombhalo
slindwe - silindwe
ywaqhatha - yawaqhatha
uzozithatela - uzozithathela
ahlle - ahlale
cwaingo - cwaningo
bude - Ubude
owazia - owaziwa
ngeshlalo - ngesihlalo
yio - yiso
ngikuqembuela - ngikuqembulela
kumele - akumele
emigqni - emigqeni
uuxosha - ukuxosha
okakwakhe - okwakwakhe
oala - ozala
samaje - samanje
nokuele - nokumele
iwo - yiwo
ekugineni - ekugcineni
yiona - yiwona
ukungaqondsisi - ukungaqondisisi
gendlu - ngendlu
Njengalpho - Njengalapho
kwesaba - ukwesaba
okukhothama - kokukhothama
yio - yiyo
kuhlziywe - kuhlaziywe
wayebna - wayebona
isibi - sisibi
abehezi - abehlezi
szalwa - sizalwa
wagnwa - waganwa
lphuma - laphuma
becshunwa - becashunwa
usio - usiko
thule - ethule
siuthe - sibuthe
Wsondela - Wasondela
akuseko - akusekho
whlulwa - wehlulwa
izinganekwae - izinganekwane
imiingo - imiqingo
somlano - somlando
ezibili - ezimbili
seziqoqlwa - seziqoqelwa
ukvuselelwa - ukuvuselelwa
nwalabo - nawalabo
siwa - usiwa
iiyohlala - isiyohlala
uybona - uyabona
Kukuo - Kukuso
abambala - abambalwa
ukupatha - ukuphatha
kwakunomui - kwakunomuzi
ekutini - ekuthini
ingfuni - ingafuni
yathela - yathelwa
yokgagula - yokugagula
wakwemuela - wakwemukela
incindezelo - ingcindezelo
olwekosi - olwenkosi
kenkosi - kwenkosi
babengamaqawe - babengamaqhawe
wabtshela - wabatshela
omhlaba - womhlaba
kunisa - ukunisa
ngenkoi - ngenkosi
kai - kabi
kwthu - kwethu
uliqhawe - kuliqhawe
waphnda - waphinda
ngoMantanisi - ngoMantantisi
kubekwe - kubhekwe
ayezinkwe - ayezinikwe
umthaathi - umthakathi
icabnga - icabanga
ylindela - yalindela
njenento - njengento
osekuwle - osekuwele
kuncke - kuncike
bziswa - baziswa
wsulelwa - wesulelwa
ithima - ithimba
shmi - shumi
ngokwenzia - ngokwenziwa
dla - adla
Jaa - Jama
behaba - behamba
szibhalwe - sezibhalwe
wbhala - wabhala
ebye - ebuye
buya - ebuya
nemisndo - nemisindo
nangomtelela - nangomthelela
Simphwe - Simphiwe
kweimbongi - kwezimbongi
Askho - Asikho
nokunokwethu - nokungokwethu
ngokwelulwa - ngokwehlulwa
Bngenisa - Bangenisa
zobonga - azobonga
yyikwenziswa - yayikwenziswa
ebhale - ebhalwe
kwedlovukazi - kwendlovukazi
sesibua - sesibuya
phethwe - iphethwe
ubebeka - ubebheka
nomgumo - nomgqumo
abdumile - abadumile
okwmvulela - okwamvulela
nolazi - nolwazi
ithe - itshe
wakungenxa - kwakungenxa
eziwumthmbo - eziwumthombo
ohalayo - obhalayo
aningi - kaningi
eyaiwayo - eyaziwayo
kuyocela - ukuyocela
angnhlalo - angenhlalo
ukublisa - ukubalisa
buyela - abuyela
Kwabamnama - Kwabamnyama
zikuo - zikuso
eyabtha - eyabutha
njengesibongwna - njengesibongwana
ebhaela - ebhalela
oklo - okulo
eyshumi - eyishumi
ngeithetho - ngemithetho
phzu - phezu
uphkisane - uphikisane
uphkisana - uphikisana
thwele - ethwele
kufunda - ukufunda
bcacelwe - bacacelwe
eebalekele - esebalekele
yeha - yehla
ngoutsho - ngokutsho
uhobo - uhlobo
yabambna - yabambana
gezici - ngezici
ababeuya - ababebuya
kunokuhala - kunokubhala
yeyintatheli - ayeyintatheli
akuele - akuvele
abaseancane - abasebancane
kelinye - kwelinye
bezomlano - bezomlando
kuna - ukuna
silihithe - silichithe
ngokusoala - ngokusobala
waantu - wabantu
mha - mhla
ngokujwaylekile - ngokujwayelekile
wayeeminyaka - wayeneminyaka
engakubuyazi - engakuMbuyazi
majalo - manjalo
umnakwbo - umnakwabo
negqondo - nengqondo
abafundi - wabafundi
wma - wema
lna - lena
Bngindoda - Bangindoda
abavakahela - abavakashela
iksho - ikusho
ehinteka - ethinteka
asemayini - yasemayini
oisa - ofisa
zihophoza - ziphophoza
zuzwana - mzuzwana
kuopha - kuqopha
ukya - ukuya
kubaluleile - kubalulekile
neala - nebala
eliziele - elizimele
ikwazi - sikwazi
Siuye - Sibuye
engiishoyo - engiyishoyo
yawo - Nyawo
Kwakunundlunkulu - Kwakungundlunkulu
ETI - ETHI
ayeethi - ayesethi
ngeinkinga - ngezinkinga
nasegungundlovu - naseMgungundlovu
kukaZuu - kukaZulu
sezo - senzo
Umloo - Umlomo
mehlko - mehluko
unsifo - unesifo
okuyinksi - okuyinkosi
uykucacisa - uyakucacisa
lzi - lezi
entobini - entombini
kwakkhona - kwakukhona
kuyisiodlo - kuyisigodlo
inythi - inyathi
ezningi - eziningi
ekulelwe - ekhulelwe
ayobulala - ayombulala
singzi - singazi
babiele - babikele
lkweshwama - lokweshwama
abeizwe - abezizwe
elungsa - elungisa
inalo - injalo
nsuu - nsuku
ailwa - ayilwa
blahlwe - belahlwe
hela - Phela
ssikhethiwe - sesikhethiwe
udingeke - ludingeke
anukuza - Manukuza
naanumzane - nabanumzane
adabula - wadabula
ngemi - angemi
ngimela - ngimelwa
anena - angena
kungabanwana - kungabantwana
kunamndla - kunamandla
kweikabhadakazi - kwesikabhadakazi
awabuele - awabuyele
ongthi - ongathi
siyawazi - siyakwazi
wawa - wakwa
ahuliswa - akhuliswa
lokuxxa - lokuxoxa
kuhlale - okuhlale
ifido - ifindo
evkele - evikele
ngesezo - ngesenzo
uhondlo - uKhondlo
iyakwai - iyakwazi
ngezibogo - ngezibongo
kwababesemzabalazwei - kwababesemzabalazweni
idlovu - indlovu
yayisphake - yayisiphake
ayeina - ayesina
izigdi - izigodi
zazbhalwe - zazibhalwe
ukphindiselela - ukuphindiselela
awakuthkozelanga - awakuthokozelanga
kwamanoeli - kwamanoveli
Yiloa - Yilona
sokbusa - sokubusa
okucwningwayo - okucwaningwayo
ingbuzwa - ingabuzwa
wakhothaa - wakhothama
njegamabhubesi - njengamabhubesi
ayeithole - ayeyithole
emadoaneni - emadodaneni
uselisheklezile - uselishekelezile
yathukuthla - yathukuthela
Dhomo - Dhlomo
omhambi - yomhambi
okuyibhage - okuyibhange
sikhulu - isikhulu
Islezwe - Isolezwe
nowabhalwa - nokwabhalwa
eyokthi - eyokuthi
yokuhluezeka - yokuhlumezeka
ungayiphthi - ungayiphathi
ayeqanje - ayeqanjwe
aethwe - alethwe
gokuxhashazwa - ngokuxhashazwa
olwausetshenziswa - olwalusetshenziswa
waKwaulu - waKwaZulu
eemva - esemva
wayengwasemzini - wayengowasemzini
nesshiyagalombili - nesishiyagalombili
ehlezi - behlezi
eso - esho
kakusasukela - kwakusasukela
angalubuka - angahlubuka
lamahunu - lamaBhunu
okuyizehakalo - okuyizehlakalo
owayngacabanga - owayengacabanga
ngokwmazinga - ngokwamazinga
bhlasela - behlasela
wayesyilungu - wayeseyilungu
okwakungMagedama - okwakunguMagedama
bageka - bagxeka
eenywa - emenywa
ingasakhumbuli - singasakhumbuli
Kuzophawula - Kuzophawulwa
lukaMboha - lukaMbopha
ukhosana - uMkhosana
ksuselwe - kususelwe
wakunokwenzeka - kwakunokwenzeka
wabahahlameza - wabakhahlameza
namaqniso - namaqiniso
uchungechnge - uchungechunge
ezinklu - ezinkulu
liwushiile - liwushiyile
lake - lakhe
ukho - kukho
sibidi - sibindi
aona - abona
okudingea - okudingeka
aphuwe - aphucwe
babeke - babekwe
libuye - elibuye
kwenodana - kwendodana
Nandi - uNandi
zimpini - ezimpini
wenosi - wenkosi
eqoqo - neqoqo
yaqnjwa - yaqanjwa
ukuundisa - ukufundisa
Zkhona - Zikhona
ikezele - iklezele
wayehamisana - wayehambisana
zibuza - ezibuza
bauyela - babuyela
egizelela - egcizelela
khumbula - ikhumbula
kbonakala - kubonakala
izinszwa - izinsizwa
ayikweni - ayikwenzi
uMbui - uMbusi
kuyona - Akuyona
masotsha - amasotsha
azochzwa - azochazwa
saehlobo - sasehlobo
khulume - ikhulume
ifinelele - ifinyelele
iele - icele
ukuyohasela - ukuyohlasela
esngumfana - esengumfana
lkukhothama - lokukhothama
abasuelwe - abasuselwe
snke - sonke
kulnganwe - kulinganwe
yayihukumeza - yayihlukumeza
kunqoba - okunqoba
lintogande - lintongande
kunigi - kuningi
ymbhalo - yombhalo
ekukhombei - ekukhombeni
Kwapuma - Kwaphuma
owayenenaba - owayenenqaba
yokzalwa - yokuzalwa
ezinleleni - ezindleleni
umdandla - umdlandla
nzizathu - nezizathu
ukulngisa - ukulungisa
Akuvea - Akuveza
kungahloniphi - ukungahloniphi
kwauba - kwakuba
ngnhloso - ngenhloso
lwalandla - lwalandela
amaama - amagama
Nguena - Nguyena
zenxoxo - zengxoxo
iyavumlana - iyavumelana
yokuansa - yokudansa
iinceku - izinceku
yokugxeka - yokugxekwa
anga - langa
izvuka - izovuka
iwukuqhathanisa - siwukuqhathanisa
zama - uzama
efuleni - emfuleni
olwae - olwase
ezobsa - ezobusa
yasetha - eyasetha
ethembisa - wethembisa
kwvuka - kwavuka
eyethlwa - eyethulwa
zilandelansa - zilandelanisa
oSikhombazane - noSikhombazane
elandelanyo - elandelanayo
yayihlele - yayihlelwe
isiphuu - isiphuku
nmlungu - nomlungu
kangangkuthi - kangangokuthi
kwaulwa - kwakulwa
nabntu - nabantu
egungundlovu - eMgungundlovu
waybhala - wayebhala
gosuku - ngosuku
okungkho - okungekho
whamba - wahamba
nokwandsa - nokwandisa
eyomie - eyomile
saqhubeka - Isaqhubeka
Untwana - Umntwana
seibongweni - sezibongweni
ayophenya - bayophenya
ngudadeabo - ngudadewabo
naanye - nabanye
zithuta - zithutha
sondele - isondele
oyimongi - oyimbongi
singakauboni - singakakuboni
efundle - efundile
wayozianisa - wayoziganisa
amaKhoi - amaKhosi
egaziwa - engaziwa
iemezela - imemezela
uisekazi - uyisekazi
UMntwna - UMntwana
Indovukazi - Indlovukazi
oehlukanisayo - ozehlukanisayo
Abahali - Ababhali
kaNomaeja - kaNomageja
indu - indlu
baguula - baguqula
ihlewe - ihlelwe
athumela - sathumela
Dbe - Dube
uyothingwa - uyotshingwa
owaysesele - owayesesele
kendlu - kwendlu
ethi - bethi
betu - bethu
walida - walinda
lezmbangazwe - lezombangazwe
ukwabamba - ukuwabamba
uzokuthla - uzokuthola
bayongnisa - bayongenisa
kuowo - kulowo
amzwi - amazwi
uzmisele - uzimisele
iyobulla - iyobulala
jengekusasa - njengekusasa
owabalea - owabaleka
yokubidliza - yokubhidliza
Ngokwamagisi - NgokwamaNgisi
nguMbndi - nguMbondi
kungexa - kungenxa
nendna - nenduna
Ngeminaka - Ngeminyaka
lana - landa
lisemsebenzini - elisemsebenzini
zilandelae - zilandelane
Kwetulwa - Kwethulwa
bvele - bavele
Iminyaa - Iminyaka
aveza - Waveza
bavze - baveze
ngenjono - ngenjongo
ezoqhathaiswa - ezoqhathaniswa
wwubabaza - wawubabaza
yibuzanga - ayibuzanga
ayobe - bayobe
umehluo - umehluko
Ngouhamba - Ngokuhamba
msindo - umsindo
kungezenosi - kungezenkosi
ngoukhuthaza - ngokukhuthaza
ukze - ukuze
olubhale - olubhalwe
gezinye - ngezinye
opheele - ophelele
esikuluma - esikhuluma
 - Mnu
ukuhazela - ukuchazela
lubizwa - olubizwa
oldinga - oludinga
kwashicielwa - kwashicilelwa
Baixhumanisa - Bazixhumanisa
yezenhlao - yezenhlalo
ngkwaleyo - ngokwaleyo
ukufza - ukufeza
baganae - baganane
kwaMthetha - kwaMthethwa
nabatwana - nabantwana
usbenzela - usebenzela
yoa - yona
Kuike - Kufike
mnyama - emnyama
Kwausemini - Kwakusemini
aalwa - azalwa
inazelele - ingazelele
wlwa - walwa
kuqinisekisa - ukuqinisekisa
enzie - enzile
aabefuna - ababefuna
Ayizane - Ayizange
ngamaoqo - ngamaqoqo
antambama - yantambama
linganaso - lingangaso
nobudelwano - nobudlelwano
kuthada - kuthanda
okuyihlazo - nokuyihlazo
amathamo - amathambo
amaembu - amaqembu
kuba - Ukuba
uzovzwa - uzovezwa
lamvibela - lamvimbela
yaqoha - yaqopha
kweze - kwenze
ezse - ezase
kwqhamuka - kwaqhamuka
thuba - ithuba
nomphakahi - nomphakathi
yindlela - iyindlela
ukwehlukanswa - ukwehlukaniswa
wayesthe - wayesethe
blowo - balowo
oala - obala
mkhoto - mkhonto
eyayikhuulekile - eyayikhululekile
saiswa - saziswa
njengewala - njengegwala
abeko - abekho
ababethegisela - ababethengisela
sekubhalie - sekubhaliwe
ezaa - ezala
igachazwa - ingachazwa
betumela - bethumela
imiudu - imigudu
ehlahini - ehlathini
bazina - bazinza
kunokufna - kunokufana
ngokuqoba - ngokunqoba
sahela - sahlela
zasNatali - zaseNatali
isilonipho - isihlonipho
senveli - senoveli
babeyibia - babeyibiza
bobukhoi - bobukhosi
sembhalo - semibhalo
oguquko - soguquko
yezinhoso - yezinhloso
nlibo - nolibo
Akuona - Akulona
kwmenzela - kwamenzela
eyaqaa - eyaqala
iziha - izitha
Ukunqtshwa - Ukunqotshwa
kugxekeni - ekugxekeni
ykubekwa - yokubekwa
nomlado - nomlando
kokuhala - kokubhala
sekublawa - sekubulawa
kyofika - kuyofika
ngesio - ngesilo
elothwe - elotshwe
nokuxxa - nokuxoxa
sithahwe - sithathwe
owawusuthada - owawusuthanda
nokukhuunywayo - nokukhulunywayo
yoMkhoto - yoMkhonto
iznkathi - izinkathi
nsezibongweni - nasezibongweni
kkade - kakade
kuncae - kuncane
kuhlala - kuhlalwa
kouzi - komuzi
eigodlela - ezigodlela
ubunkodlo - ubunkondlo
Uuze - Ukuze
wedlovukazi - weNdlovukazi
jengemithombo - njengemithombo
Arika - Afrika
amukelwa - samukelwa
efaele - efanele
ayibheke - ayibhekwe
kuhotheme - kukhotheme
bahlziye - bahlaziye
ubhlakani - ubuhlakani
qinisile - eqinisile
kulou - kulolu
aJama - kaJama
Mayelna - Mayelana
ngenovei - ngenoveli
engabahlniphi - engabahloniphi
namautho - namabutho
kwekhthelo - kwekhethelo
ngokuqeesha - ngokuqeqesha
oayefunde - owayefunde
edule - edlule
okuhaya - zokuhaya
Sthumela - Sathumela
uMlusi - uMalusi
oziambelayo - oziqambelayo
ezifudisa - ezifundisa
aysecela - ayesecela
ilapo - ilapho
elandelwe - elandeliwe
esinonzo - esinzonzo
ebezbukwa - ebezibukwa
akhona - nakhona
kumyelana - kumayelana
okwakuseizweni - okwakusemizweni
igome - iNgome
izihamu - izibhamu
alwea - alwela
yilpho - yilapho
saphupa - saphupha
okwkungakholeki - okwakungakholeki
yawelea - yawelela
sekue - sekufe
baahlelo - bamahlelo
komneabo - komnewabo
intathu - zintathu
kuMasa - kuMbasa
okubonkalayo - okubonakalayo
ekuzoba - sekuzoba
iqqo - iqoqo
onohlone - onohlonze
Kwkushiwo - Kwakushiwo
iqoa - iqoqa
shloko - sihloko
kusae - kusale
ogcwee - ogcwele
lokubthwa - lokubuthwa
okwabnga - okwabanga
eqkothiswe - eqokothiswe
nokuhabana - nokuhlabana
laha - lapha
Nkwezinye - Nakwezinye
kuhi - kuphi
isse - isuse
ngoktholakala - ngokutholakala
ukuundwa - ukufundwa
Kwauthi - Kwakuthi
iskude - isekude
kuvzwa - kuvezwa
elilulele - elidlulele
Kuaye - Kuyaye
owayeyqhawe - owayeyiqhawe
ezae - ezabe
okukhoma - okukhomba
Yingkho - Yingakho
ayingeyena - yayingeyena
uKhshwayo - uKhushwayo
ombili - zombili
Engasallanga - Engasalalanga
baththe - bathathe
namaye - namanye
kugcine - kugcinwe
kucinwa - kugcinwa
kwioveli - kwinoveli
ebephaka - sebephaka
usuelwa - ususelwa
ihovisi - ihhovisi
yabulaa - yabulala
baibulale - bayibulale
nlimi - nolimi
enasizwa - engasizwa
omlndo - omlando
ezazibatshla - ezazibatshela
ayikaele - ayikazele
aisusela - azisusela
iiqu - iziqu
aybhala - ayebhala
bayavmelana - bayavumelana
kaShanu - kaShandu
yene - yenye
iisu - izisu
wagoela - wagomela
siphue - siphume
sphuma - siphuma
ukugcia - ukugcina
ezigakholakali - ezingakholakali
ukfika - ukufika
pande - Mpande
naseNkndla - naseNkandla
siulale - sibulale
encae - encane
aihlole - ayihlole
yaloho - yalokho
onothano - onothando
kohasela - kohlasela
eyiqiisa - eyiqinisa
oselaqeda - oselwaqeda
amabina - amabinza
umlingisa - umlingiswa
obabele - obambele
nokuhlela - ngokuhlela
okungaqondaali - okungaqondakali
nkundla - inkundla
ezincwadi - nezincwadi
usho - kusho
incibiikile - incibilikile
ususelwa - Kususelwa
Uutshalwa - Ukutshalwa
ouncane - okuncane
amaungelo - amalungelo
Kuuke - Kusuke
iygeza - iyogeza
Kuambisane - Kuhambisane
osihlko - osihloko
njegaqukethe - njengaqukethe
kwenzekai - kwenzekani
ngemisebeni - ngemisebenzi
izikabi - izinkabi
okugcinwa - sokugcinwa
basle - basale
ukuxhuana - ukuxhumana
sbulawe - sibulawe
kungezokudabka - kungezokudabuka
laliyoshoa - laliyoshona
Isifanio - Isifaniso
ukvezwa - ukuvezwa
szobabulala - sizobabulala
weNosi - weNkosi
ibnakale - ibonakale
zihlanabezana - zihlangabezana
aylanda - ayolanda
kukaMbuyaze - kukaMbuyazwe
nokunqoa - nokunqoba
umabhalne - umabhalane
yakuqinisekisa - uyakuqinisekisa
ukufnekisa - ukufanekisa
komsebeni - komsebenzi
Ukulamisa - Ukulambisa
ugineke - ugcineke
Kuzonikeza - Kuzonikezwa
wezibongo - kwezibongo
kwehlukie - kwehlukile
eyaa - eyaba
ona - bona
ukuzoibona - ukuzoyibona
besisikulu - besisikhulu
olanele - olwanele
babengosmlando - babengosomlando
qenjini - eqenjini
wayesesebnzela - wayesesebenzela
kugenziwa - kungenziwa
wezigaba - kwezigaba
besiwe - besizwe
olakeni - ohlakeni
Ukunika - Ukuncika
bayocsha - bayocasha
madodna - madodana
izidlu - izindlu
yakomba - yakhomba
ehlangania - ehlanganisa
abona - sabona
awushsa - awushisa
Yilpho - Yilapho
okuladelwa - okulandelwa
wesidino - wesidingo
olukhumbulekyo - olukhumbulekayo
awa - alwa
engasetshenzisa - engasetshenziswa
yailwa - yayilwa
saseSndlwana - saseSandlwana
ookuthula - onokuthula
sebzohlasela - sebezohlasela
ngokbenzisa - ngokubenzisa
yezinlela - yezindlela
lidume - elidume
mzala - umzala
nowasuka - nokwasuka
izivakasi - izivakashi
yaeMatshalini - yaseMatshalini
noadewabo - nodadewabo
oydwa - oyedwa
kuwukethulwa - kuwukwethulwa
wawaqona - wawaqonda
azbhala - azobhala
imee - imele
gobuzwe - ngobuzwe
eodwa - eyodwa
ndumo - nodumo
buka - abuka
uththwa - uthathwa
nhle - inhle
Kwabutha - Kwabuthwa
uyagza - uyageza
baizwe - babizwe
Saska - Sasuka
izibzi - izibazi
Isielo - Isicelo
uazibuko - uMazibuko
aamnyama - abamnyama
thanda - ithanda
obacekea - obacekela
iyisifaniso - siyisifaniso
ekhuthze - ekhuthaze
abuzile - Babuzile
blwa - balwa
oayenonya - owayenonya
abaundi - abafundi
luqhathnisa - luqhathanisa
yombubi - yombumbi
engasyihloniphi - engasayihloniphi
kudina - kudinga
efia - efika
waubeka - wakubeka
kwaKhethphela - kwaKhethiphela
ukuphndula - ukuphendula
Smehlula - Samehlula
kngekho - kungekho
abasebebulwe - abasebebulewe
laseNatai - laseNatali
zalwa - uzalwa
kuobala - kusobala
Mbukei - Mbukeni
anomna - anomona
abue - abuye
abue - abuze
abe - sabe
Kwakuhaya - Kwakuhaywa
zinkodlo - zinkondlo
zyeke - ziyeke
luzocacsa - luzocacisa
ymhla - yamhla
eliona - elibona
sesiyoiphindiselela - sesiyoziphindiselela
izanui - izanusi
usebezise - usebenzise
wathmela - wathumela
umuhi - umuthi
wasbaphendula - wasebaphendula
kwecwadi - kwencwadi
esingati - esingathi
wyeyenza - wayeyenza
ila - idla
wokenyanya - wokwenyanya
engingakae - engingakaze
Eilotshiwe - Ezilotshiwe
komthetho - komthemtho
hlazo - ihlazo
Baika - Bafika
abuye - sabuye
sasuwa - sasuswa
kwezihlanu - kwezihlangu
kwabanwana - kwabantwana
kuamele - kusamele
naadla - nabadla
Kwamaama - Kwamagama
bawabza - bawabiza
Ngaike - Ngafike
seynqobe - seyinqobe
inhlko - inhloko
ekuqueni - ekuquleni
oknye - okanye
oveze - ovezwe
yaesandleni - yasesandleni
uybiza - uyibiza
wawakombisa - wawakhombisa
ayibona - bayibona
ziyinkulmo - ziyinkulumo
ngegai - ngegazi
ezilwane - yezilwane
seibanjwa - sesibanjwa
yokubuyislwa - yokubuyiselwa
yasebenisa - yasebenzisa
nenhliziyo - inenhliziyo
gobunyoninco - ngobunyoninco
beona - bebona
azazi - zazazi
okuhywayo - okuhaywayo
zeintu - zesintu
zono - izono
nanokubulawa - nangokubulawa
oyioveli - oyinoveli
Sikhipa - Sikhipha
aze - saze
syo - sayo
bedelea - bedelela
kekubalwe - kekubhalwe
khoa - khona
sekuyavea - sekuyavela
wayewumzala - owayewumzala
waya - owaya
okwakhiwa - yokwakhiwa
UNmatshali - UNomatshali
bazizwa - abazizwa
elsile - elusile
kuphthwa - kuphathwa
Ezinigi - Eziningi
iizwe - isizwe
seyibaleela - seyibalekela
ayisuka - yayisuka
Wzihlaba - Wazihlaba
iqhaa - iqhaza
ihasele - ihlasele
ubni - ubani
misha - emisha
nkungathembeki - nokungathembeki
zibonele - ezibonele
ialandele - ibalandele
kunaba - kungaba
seithupha - sesithupha
saka - sakha
zibankela - zibanukela
skho - sakho
yehu - yethu
iqhwe - iqhawe
ethuba - ethumba
elinamashumi - elingamashumi
yeluliwe - yehluliwe
kugana - ukugana
Izinkmo - Izinkomo
ezazihaya - ezazihaywa
ezgqamile - ezigqamile
zisebenzsa - zisebenzisa
wakucaisa - wakucacisa
zisebenise - zisebenzise
sihlalweni - esihlalweni
yayithada - yayithanda
ungcwatshwe - kungcwatshwe
ekhluma - ekhuluma
ayinkezi - ayinikezi
njengotisha - njengothisha
sikona - sikhona
yiaba - yilaba
asegamagama - asengamagama
aabesuke - ababesuke
uhintsho - ushintsho
lalixeka - laligxeka
bewe - bezwe
lwayizahluo - lwayizahluko
bebaelwa - bebalelwa
wayesekhombia - wayesekhombisa
kaZiode - kaZikode
liyaetshenziswa - liyasetshenziswa
Iziyembezi - Izinyembezi
enazinikele - engazinikele
semishii - semishini
kwakunelona - kwakungelona
weznsizwa - wezinsizwa
abahali - ababhali
iyakuvuela - iyakuvumela
Umlano - Umlando
eyyibabona - eyayibabona
kekho - akekho
kzosetshenziswa - kuzosetshenziswa
nanoma - nganoma
isigumbusi - isingumbusi
ntengweni - Intengweni
ngouba - ngokuba
babulawa - ababulawa
sonana - sonkana
ayeyimbongi - wayeyimbongi
abeke - babeke
silokhu - isilokhu
Mbpha - Mbopha
yasedoloheni - yasedolobheni
lwbantu - lwabantu
ezingne - ezingane
ziqu - Iziqu
ugwyi - ugwayi
bala - ubala
awaZulu - akwaZulu
zilehe - zilethe
mnga - manga
uzohlaziywa - kuzohlaziywa
maphephandba - maphephandaba
eqondweni - emqondweni
uklobola - ukulobola
endoda - nendoda
acashe - bacashe
kwezlimi - kwezilimi
yiqawe - yiqhawe
wawayaa - wawayala
ihlwa - iholwa
zaizama - zazizama
Izie - Iziwe
kensimbi - kwensimbi
ukungahambisni - ukungahambisani
Bavivinya - Bamvivinya
enngi - eningi
Ngipheta - Ngiphetha
umhlaho - umhlapho
ezalandlwa - ezalandelwa
omphafa - somphafa
yaowo - yalowo
amakhada - amakhanda
wna - wona
zinkinga - izinkinga
uhuqe - ubhuqe
ngsemfuleni - ngasemfuleni
yonaka - yonyaka
nabacwanini - nabacwaningi
kucelisa - ukucelisa
ukuhula - ukukhula
kwembuzi - okwembuzi
ysizwe - yisizwe
iitshelwa - isitshelwa
owbe - owabe
okuhlanekzelwe - okuhlanekezelwe
batu - bantu
gengxoxo - ngengxoxo
elohu - elokhu
wakazi - wakwazi
wnamuhla - wanamuhla
sinamndla - sinamandla
owo - lowo
ngmuntu - ngomuntu
babzana - babuzana
Ngamaye - Ngamanye
abeza - babeza
enjngokubekwa - enjengokubekwa
owaebusela - owayebusela
uwethula - ukwethula
eseubuyisa - esewubuyisa
iyazi - Siyazi
yakiti - yakithi
enhiziyweni - enhliziyweni
Ukungboni - Ukungaboni
inongo - injongo
eyayihi - eyayithi
abngasuselwa - abangasuselwa
zazfika - zazifika
uyieza - uyiveza
iikhombisani - isikhombisani
Wmudla - Wamudla
empni - empini
eyidodana - eyindodana
ocidezelwayo - ocindezelwayo
yemilo - yempilo
simbna - simbona
yayisingthwe - yayisingethwe
sebeke - asebeke
yakaNdlangamandla - yakwaNdlangamandla
ebuncanni - ebuncaneni
aabebhalelwe - ababebhalelwe
illela - ilalela
nemigoo - nemigomo
nedlela - nendlela
ivewe - ivezwe
iveza - ivezwa
uMangcengza - uMangcengeza
ukungwi - ukungawi
naabhali - nababhali
gemihlambi - ngemihlambi
Magema - uMagema
ethle - ethile
siziize - sizibize
belidunyisa - belidunyiswa
buya - Abuya
izodwa - izondwa
baliwe - badliwe
yaysazimisele - yayisazimisele
nemisebnzi - nemisebenzi