olwallutholakala - olwalutholakala
okubhaliweyho - okubhaliweyo
elisusedlwa - elisuselwa
kuyazcaciswa - kuyacaciswa
esakuhlelewka - esakuhleleka
awagaqne - awagane
ubukwea - ubukwa
kwealaba - kwalaba
wayesevelke - wayesevele
kuyindllela - kuyindlela
nallutho - nalutho
kuuMbopha - kuMbopha
imikhuiba - imikhuba
ngenhlakanbipho - ngenhlakanipho
sipohaka - siphaka
zxifika - zifika
kwaslani - kwalani
nazlolu - nalolu
lahlukazniswe - lahlukaniswe
uikucwasana - ukucwasana
basyishicilela - bayishicilela
aqthole - athole
ezinsxundu - ezinsundu
yokuhloniphya - yokuhlonipha
uMJbulazi - uMbulazi
ukluqoqa - ukuqoqa
sxesehlule - sesehlule
enonyta - enonya
owawunemibandelka - owawunemibandela
woklubongela - wokubongela
kaMagavuzai - kaMagavuzi
Ngokwsesibonelo - Ngokwesibonelo
bahlukenhe - bahlukene
abazvumelana - abavumelana
ikngabe - ingabe
wernza - wenza
yayisibvuthe - yayisibuthe
ingabga - ingaba
kayihaqmbe - kayihambe
ekuyiqonbdeni - ekuyiqondeni
wakiwaKhumalo - wakwaKhumalo
LLabo - Labo
zombnuso - zombuso
NHjengoba - Njengoba
wayenbenqubo - wayenenqubo
sezisendleledni - sezisendleleni
bvakubhale - bakubhale
wwamaNgisi - wamaNgisi
emanzinmi - emanzini
kwezwei - kwezwi
asamhloniphga - asamhlonipha
baqbe - babe
kwakungamasngalisi - kwakungamangalisi
ngengfila - ngengila
umgfqumo - umgqumo
bvafa - bafa
Akkuphawula - Akuphawula
kwakuungomunye - kwakungomunye
ngempiilo - ngempilo
yayigfane - yayigane
ermagameni - emagameni
Wakubekia - Wakubeka
uDingisxwayo - uDingiswayo
eswasinephupho - esasinephupho
ndlou - ndlu
Cetswhwayo - Cetshwayo
nbgezilimi - ngezilimi
zibhalwwa - zibhalwa
basphile - baphile
umnculi - umculi
ukholko - ukholo
esikolerni - esikoleni
kaMbondei - kaMbondi
Konkje - Konke
basni - bani
mmama - mama
UUyithanda - Uyithanda
agfxile - agxile
lokulwqa - lokulwa
emlothjeni - emlotheni
Ukujfunda - Ukufunda
kwebuthgo - kwebutho
esibhedkene - esibhekene
sesinqwotshwe - sesinqotshwe
omubgi - omubi
lwaziwse - lwaziwe
abazbephila - ababephila
uvamikse - uvamise
Kuushiwo - Kushiwo
ngewzindlela - ngezindlela
wesiloo - wesilo
eseneminyyaka - eseneminyaka
izehnlula - izehlula
eyayiongafuni - eyayingafuni
Ayisetshyenziswa - Ayisetshenziswa
uZiobhebhu - uZibhebhu
nghinikele - nginikele
impakla - impaka
basbethi - babethi
omudce - omude
yisithandswa - yisithandwa
nhlanbgothi - nhlangothi
okluwumgogodla - okuwumgogodla
ayifuynde - ayifunde
bvazo - bazo
yhacela - yacela
bayte - baye
bayto - bayo
asbabewunikeza - ababewunikeza
ukuhlawulla - ukuhlawula
bneqedwa - beqedwa
ababeyelouleka - ababeyeluleka
ehunyushelowe - ehunyushelwe
kukaBhambatyha - kukaBhambatha
lkuseluningi - luseluningi
aytezifundisa - ayezifundisa
ehlangasbezana - ehlangabezana
okwwakubhalwe - okwakubhalwe
asKwaZulu - aKwaZulu
okuuthathwe - okuthathwe
ngellokuthi - ngelokuthi
abuloawa - abulawa
umphakatrhi - umphakathi
Isikhonhyane - Isikhonyane
kuyyaphikisana - kuyaphikisana
kkwesikhashana - kwesikhashana
ngokuvakasdhelwa - ngokuvakashelwa
omakotri - omakoti
ukwaziwwa - ukwaziwa
njengomjhleli - njengomhleli
uzobhgeka - uzobheka
ekutrheni - ekutheni
llalisho - lalisho
nesigamneko - nesigameko
ichazaa - ichaza
ehylulwe - ehlulwe
nazmandla - namandla
omhylophe - omhlophe
abasfisa - abafisa
okuyisikkhathi - okuyisikhathi
ubguso - ubuso
ayiliwanbga - ayiliwanga
ezaqzahlulwe - ezazahlulwe
Umfrowabo - Umfowabo
ikvuke - ivuke
Ikhonbsathi - Ikhonsathi
wazyohlangana - wayohlangana
eesenukelwa - esenukelwa
kwengcxindezi - kwengcindezi
nokunghanaki - nokunganaki
oyuothatha - oyothatha
ngoklubachaza - ngokubachaza
neyasdekhohlwa - neyasekhohlwa
nkinbga - nkinga
kwakujqhutshwa - kwakuqhutshwa
ubalujlekile - ubalulekile
MntakaNdaqba - MntakaNdaba
ngokuyqhathanisa - ngokuqhathanisa
uumlobi - umlobi
inhgumuntu - ingumuntu
owayesiina - owayesina
uumndeni - umndeni
wwonke - wonke
okuvfeza - okuveza
izimpiklo - izimpiko
yabnhuqa - yabhuqa
sehylo - sehlo
Abahllalanga - Abahlalanga
awazanbge - awazange
bengonyamna - bengonyama
njerngengugo - njengengugo
nhobuhlakani - nobuhlakani
Ukudinmgisa - Ukudingisa
kuihlale - kuhlale
erndleleni - endleleni
kwamaqnye - kwamanye
uibubi - ububi
eyahylalisana - eyahlalisana
kwamasZulu - kwamaZulu
sukju - suku
OOkunye - Okunye
kiwakudunyiswa - kwakudunyiswa
babuyye - babuye
sehloula - sehlula
ngezinhloobo - ngezinhlobo
njengezibopngo - njengezibongo
ukubvanjwa - ukubanjwa
emlanbdweni - emlandweni
ekukhuileni - ekukhuleni
Esingernisweni - Esingenisweni
nebvhola - nebhola
isaheshisa - isheshisa
lesikZulu - lesiZulu
kuvcume - kuvume
oluyimfiihlo - oluyimfihlo
azchazwe - achazwe
eyasyiziqhenya - eyayiziqhenya
nesokutyhi - nesokuthi
bechyaza - bechaza
uNkunziyewzindlovu - uNkunziyezindlovu
Yiilo - Yilo
okwakwsande - okwakwande
angadfumi - angadumi
uCetshwqayo - uCetshwayo
zikyobheka - ziyobheka
lalihambiisana - lalihambisana
Kuzoqalke - Kuzoqale
ubhasle - ubhale
azaikho - azikho
ngawedlulisaa - ngawedlulisa
awubanmga - awubanga
isashyisa - isashisa
lkudinga - ludinga
isatyhathwa - isathathwa
eloalilwela - elalilwela
aqqhamuke - aqhamuke
yedfwa - yedwa
Izibongfo - Izibongo
miubuzo - mibuzo
Ukuttholakala - Ukutholakala
zioqu - ziqu
emnayelana - emayelana
yizibonhgo - yizibongo
Ushisaizwe - Ushisizwe
edmbusweni - embusweni
ledzintombi - lezintombi
ababulaledla - ababulalela
kukaqSilivana - kukaSilivana
noMnyyamana - noMnyamana
zaokwenza - zokwenza
sibukja - sibuka
iwuithola - iwuthola
umopnakalo - umonakalo
iukhula - ikhula
nangababhaloi - nangababhali
zaiye - ziye
abathintekjayo - abathintekayo
walolba - waloba
monakaslo - monakalo
nangolkubuka - nangokubuka
ezillwile - ezilwile
ebhaloiwe - ebhaliwe
abalallelayo - abalalelayo
erndizela - endizela
noikwabanye - nokwabanye
nezinbkinga - nezinkinga
bhuibhane - bhubhane
wokujxhumanisa - wokuxhumanisa
zemiobhalo - zemibhalo
ofgana - ofana
emishinmi - emishini
ubugfugu - ubugugu
unhjalo - unjalo
ukunhqoba - ukunqoba
yakhnothamela - yakhothamela
wazaiswa - waziswa
mabutrho - mabutho
wayeluuleka - wayeluleka
zazainingi - zaziningi
babelingaqniselwa - babelinganiselwa
iphatghe - iphathe
yapphuthuma - yaphuthuma
yacxishe - yacishe
yaloabo - yalabo
ashosxhozela - ashoshozela
sebezoobika - sebezobika
sasisayyibambele - sasisayibambele
nkonmyana - nkonyana
obudumiloe - obudumile
yuabuyela - yabuyela
mazqoqo - maqoqo
ujNgcobo - uNgcobo
mnyamja - mnyama
lweqikniso - lweqiniso
sakholthama - sakhothama
yhaphila - yaphila
Imigtqa - Imigqa
zingashle - zingahle
Abnazolalela - Abazolalela
kantri - kanti
ubhalwwe - ubhalwe
mpeendulwano - mpendulwano
edmpi - empi
ngolazka - ngolaka
umhlewli - umhleli
lazbo - labo
lkendlu - lendlu
ngokkuqopha - ngokuqopha
engemnyuama - engemnyama
becvela - becela
kjanye - kanye
sikaMNbuyazi - sikaMbuyazi
ehlukjanise - ehlukanise
obabungedbuhle - obabungebuhle
Izinhtombi - Izintombi
uMnyazmana - uMnyamana
nesikhombiusa - nesikhombisa
kuyiqinisdo - kuyiqiniso
avulwqe - avulwe
yasekhgohlwa - yasekhohlwa
opwodwa - owodwa
abhalowe - abhalwe
llalo - lalo
esilinganiselwwa - esilinganiselwa
ehledla - ehlela
ngqqo - ngqo
ayuifihli - ayifihli
okungabalulekikle - okungabalulekile
ngqaa - ngqa
azvele - avele
oyiovaka - oyivaka
laqna - lana
lammi - lami
ingalinmdele - ingalindele
engumhlelli - engumhleli
unomphjela - unomphela
kwababekiubhala - kwababekubhala
ngangewnzile - ngangenzile
yayihujnga - yayihunga
nobabekiazi - nobabekazi
letrhu - lethu
Isihlazngu - Isihlangu
yazyithaka - yayithaka
ethintyana - ethintana
kungasxanembile - kungasanembile
yihabva - yihaba
kjwaleli - kwaleli
waqso - waso
njhengawe - njengawe
wajazha - wajaha
bgezile - bezile
izopsiza - izosiza
Uyazithanbda - Uyazithanda
llawa - lawa
eyayinobnuntu - eyayinobuntu
nmgasekupheleni - ngasekupheleni
ikhomnbise - ikhombise
ikkhombisa - ikhombisa
ufanha - ufana
wwawo - wawo
esaeza - eseza
emukia - emuka
bazoyikhaqlela - bazoyikhalela
Impujnzi - Impunzi
wasze - waze
owayesizasna - owayesizana
wazxi - wazi
wayyo - wayo
ayokje - ayoke
ziqedde - ziqede
azimbandakaznya - azimbandakanya
akayikubvusa - akayikubusa
iizwe - izwe
ngokuqoqedla - ngokuqoqela
zaalezo - zalezo
ayiniokezwe - ayinikezwe
yasyibona - yayibona
erzazenza - ezazenza
yokwedlulla - yokwedlula
esabizwqa - esabizwa
aqngabenza - angabenza
uyfake - ufake
kuyisikhuylu - kuyisikhulu
nmjengalokhu - njengalokhu
unikewza - unikeza
uchazaa - uchaza
imemezxa - imemeza
kwentoombi - kwentombi
ayesaqkaza - ayesakaza
sasibadopnse - sasibadonse
yafrika - yafika
okuyizaona - okuyizona
wsakudala - wakudala
iphguma - iphuma
kuthinmta - kuthinta
yayhisiyoze - yayisiyoze
ngassekugcineni - ngasekugcineni
isikhgotheme - isikhotheme
ababedlandelwa - ababelandelwa
eSandlwanha - eSandlwana
nguyenha - nguyena
bnabambe - babambe
asdenze - asenze
bazbamba - babamba
engfugo - engugo
Leloi - Leli
ayeziboneele - ayezibonele
ukujqanjwa - ukuqanjwa
beyikhguza - beyikhuza
bnema - bema
labvathakathi - labathakathi
enhye - enye
wayebulalla - wayebulala
ikyongena - iyongena
nyazka - nyaka
Ledso - Leso
nguiMbopha - nguMbopha
yibonba - yibona
ihllose - ihlose
ayueveza - ayeveza
inmduna - induna
sebaqbhala - sebabhala
inmgafaniswa - ingafaniswa
ekuvuselelenhi - ekuvuseleleni
ezinikewza - ezinikeza
yayiswaba - yayisaba
ubuiya - ubuya
Isiklo - Isilo
esetyhola - esethola
ujbunye - ubunye
akhewthiwe - akhethiwe
ukwewnqaba - ukwenqaba
ayevella - ayevela
bemjazi - bemazi
njengfesenzo - njengesenzo
abafaqyo - abafayo
yimbvube - yimbube
Lezxi - Lezi
waverla - wavela
ngamanbdla - ngamandla
okulahylekayo - okulahlekayo
babekubukla - babekubuka
sathukuthelisda - sathukuthelisa
kuylindelekeni - kulindelekeni
ugcweele - ugcwele
ehlelikwe - ehleliwe
lulonkie - lulonke
seluphakiathi - seluphakathi
WQasephuma - Wasephuma
iphuzau - iphuzu
Okuuthe - Okuthe
asbabelwa - ababelwa
baqchazelwa - bachazelwa
wokubvuyiselwa - wokubuyiselwa
angtazilanda - angazilanda
Yingonyamma - Yingonyama
kunbokuphendula - kunokuphendula
nezinhlobno - nezinhlobo
baqnamagama - banamagama
iyahlopma - iyahloma
ukkuvezile - ukuvezile
bgalethwe - balethwe
kumjamitha - kumamitha
usikompillo - usikompilo
wafdunda - wafunda
owatyhatha - owathatha
ungadfliwe - ungadliwe
ekwahlulewleni - ekwahluleleni
ekushnoyo - ekushoyo
ngtaphansi - ngaphansi
yhahlala - yahlala
eyayithaqndwa - eyayithandwa
nabelunbgu - nabelungu
aqyehlala - ayehlala
sioshisa - sishisa
yalandwea - yalandwa
iundlovukazi - indlovukazi
ujdweshu - udweshu
NguiNdlunkulu - NguNdlunkulu
ewqala - eqala
kuMNntwana - kuMntwana
azosdetshenziswa - azosetshenziswa
yikjhona - yikhona
icacxe - icace
llombhali - lombhali
kiwezulu - kwezulu
Okwaklumangalisa - Okwakumangalisa
athazthwe - athathwe
semjpi - sempi
eyayisiserbenze - eyayisisebenze
siyakuvezxa - siyakuveza
kwakuhlezai - kwakuhlezi
seduzae - seduze
Amandloa - Amandla
lwalunhemibuzo - lwalunemibuzo
Ngtenkathi - Ngenkathi
nhezimbongi - nezimbongi
sastshelwa - satshelwa
belalkele - belalele
Kanjazlo - Kanjalo
owasbanga - owabanga
olwalukhjona - olwalukhona
kwakwenbzeka - kwakwenzeka
ngewbala - ngebala
luyzosiza - luzosiza
wenqatsahelwa - wenqatshelwa
ayiyobghekana - ayiyobhekana
uzxihluphe - uzihluphe
yiloina - yilona
Useloa - Usela
amaklhosi - amakhosi
elidingfa - elidinga
ihamnba - ihamba
ezindliini - ezindlini
yasbalukhuni - yabalukhuni
ewazbona - ewabona
kuzokhuluunywa - kuzokhulunywa
izizwwe - izizwe
ukulethyela - ukulethela
nakuMntwaqna - nakuMntwana
Kwakiungakaze - Kwakungakaze
benjazni - benjani
eehlukile - ehlukile
izikhyali - izikhali
wusingta - wusinga
Nghokuka - Ngokuka
klaNgongoma - kaNgongoma
labasaebenzi - labasebenzi
elikaMbuyaqzi - elikaMbuyazi
Mmagwendu - Magwendu
amgcdoba - amgcoba
obukhulou - obukhulu
sdasiyingxenye - sasiyingxenye
uklunonga - ukunonga
bebulawqa - bebulawa
sxeshuminantathu - seshuminantathu
nbangabantu - nangabantu
esabhulka - esabhula
nemmibuzo - nemibuzo
wqayedweba - wayedweba
ukhumbulla - ukhumbula
yayomiksa - yayomisa
lillihle - lilihle
ziibaluleke - zibaluleke
ezifakelwqe - ezifakelwe
iqoindise - iqondise
okuyiyonba - okuyiyona
bakuvewza - bakuveza
ngamanhoveli - ngamanoveli
njengallabo - njengalabo
busukju - busuku
yinhlasnhla - yinhlanhla
elisenbingizimu - eliseningizimu
yilkuphi - yiluphi
kwelakwaZuylu - kwelakwaZulu
eezindaweni - ezindaweni
ababelwaklhela - ababelwakhela
okuiyiqiniso - okuyiqiniso
okuxoxziswane - okuxoxiswane
kweminininhgwane - kwemininingwane
kiade - kade
eyitholoa - eyithola
ubugqiila - ubugqila
zxinye - zinye
yeminyakia - yeminyaka
iyakhothgama - iyakhothama
obekadfe - obekade
kuncikka - kuncika
iofika - ifika
iyiundaba - iyindaba
kuyenbze - kuyenze
lwalumayelazna - lwalumayelana
aqdle - adle
ngeyengbezwayo - ngeyengezwayo
ewshiswa - eshiswa
aszohlala - azohlala
sxesibusa - sesibusa
ngezainzala - ngezinzala
Sizobakledlisa - Sizobaklelisa
ingaqbanga - ingabanga
aziziqaambi - aziziqambi
sezibghalwa - sezibhalwa
klwesikhathi - kwesikhathi
babuulalane - babulalane
kuyhibutho - kuyibutho
yemvelaqphi - yemvelaphi
bakjwazulu - bakwazulu
ayesecaqsha - ayesecasha
nhgemvume - ngemvume
kuleekelelwa - kulekelelwa
ebhalkwa - ebhalwa
ngermvula - ngemvula
emaqinhisweni - emaqinisweni
akkhele - akhele
lenhziwe - lenziwe
Nkantinhi - Nkantini
elandcelanisile - elandelanisile
kwasbelungu - kwabelungu
iqhathaniksa - iqhathanisa
uNoimagaga - uNomagaga
iophaphu - iphaphu
azikushjo - azikusho
ukuqooshwa - ukuqoshwa
yezibongfo - yezibongo
owayebuiya - owayebuya
abgakhala - abakhala
swicashe - sicashe
Ukuukhuthaza - Ukukhuthaza
abuytele - abuyele
besiyenbdane - besiyendane
akukhyo - akukho
UMMnguni - UMnguni
noMfundiisi - noMfundisi
ngokwednoveli - ngokwenoveli
Awqacekeza - Awacekeza
uziqoqeela - uziqoqela
ziknto - zinto
zingafdani - zingafani
ikhjululwe - ikhululwe
seyiuhayiwe - seyihayiwe
okuzopkwenzeka - okuzokwenzeka
amaphephgandaba - amaphephandaba
owazbhala - owabhala
osebenzaisa - osebenzisa
abgancane - abancane
oikunguye - okunguye
bezizxwa - bezizwa
ookomlando - okomlando
Indllela - Indlela
zazishikwo - zazishiwo
lwesiugodlo - lwesigodlo
lesishgiyagalombili - lesishiyagalombili
NBenkosi - Nenkosi
ngathgi - ngathi
kuynenkosi - kunenkosi
sekuphonbswa - sekuphonswa
Mahlkasela - Mahlasela
ukuthandsa - ukuthanda
nbokuveza - nokuveza
ezipohawula - eziphawula
sedziningi - seziningi
ngezxithole - ngezithole
eempilweni - empilweni
kuylwa - kulwa
kjuthiwa - kuthiwa
kluthiwe - kuthiwe
asdheshe - asheshe
uNgtomane - uNgomane
lwengbxoxo - lwengxoxo
zikyawethula - ziyawethula
iuKomidi - iKomidi
elalihoolwa - elaliholwa
obuqothgo - obuqotho
yaytiganwe - yayiganwe
uykuwa - ukuwa
ezintasbeni - ezintabeni
wesiibili - wesibili
wakhuulela - wakhulela
bakwednze - bakwenze
baseMakihabeleni - baseMakhabeleni
yabasbhali - yababhali
weqaa - weqa
sxokuphumula - sokuphumula
elinamanhdla - elinamandla
yokuibhalwa - yokubhalwa
ongenammsebenzi - ongenamsebenzi
lesdi - lesi
iyinoveloi - iyinoveli
kwezinsukku - kwezinsuku
nesdahluko - nesahluko
angezae - angeze
eyayingenamboono - eyayingenambono
abaphnila - abaphila
kweenduna - kwenduna
ezintwweni - ezintweni
kluhambisana - kuhambisana
Kuhlke - Kuhle
enmgaxosha - engaxosha
ezihlazziywe - ezihlaziywe
lwehluilwa - lwehlulwa
ezxinye - ezinye
swehlukene - sehlukene
okjwenziwayo - okwenziwayo
sasyobikela - sayobikela
bamshayue - bamshaye
ziyazziqeketha - ziyaziqeketha
zenmzeke - zenzeke
bathokkozela - bathokozela
siungawi - singawi
akaytophatha - akayophatha
WWathathwa - Wathathwa
fujna - funa
Wayebnonga - Wayebonga
owayenothazndo - owayenothando
Nomma - Noma
owawubhazlwe - owawubhalwe
akuyyona - akuyona
ukkufa - ukufa
babonhe - babone
kiwathunyelwa - kwathunyelwa
eytayikhonze - eyayikhonze
Ndselu - Ndelu
kwakubalulekke - kwakubaluleke
zaenkathi - zenkathi
zoina - zona
babulazwa - babulawa
kugcinellwe - kugcinelwe
oyiqinisdo - oyiqiniso
abenolwazai - abenolwazi
ngendlewbe - ngendlebe
ixoshgise - ixoshise
Ekufikedni - Ekufikeni
Waszalelwa - Wazalelwa
nezindeaba - nezindaba
mbviko - mbiko
opkubhalwe - okubhalwe
zezaindaba - zezindaba
wayebgeka - wayebeka
yezimbonbgi - yezimbongi
abangabahlengtikazi - abangabahlengikazi
lluyithuluzi - luyithuluzi
Akuichaziwe - Akuchaziwe
Okuqukethjwe - Okuqukethwe
Kuyngakho - Kungakho
ukuzibhazlela - ukuzibhalela
ziyolwea - ziyolwa
minme - mine
emhloane - emhlane
wamboipha - wambopha
minha - mina
yepphucwa - yephucwa
kuyobammba - kuyobamba
ngowokuqwala - ngowokuqala
azxiqambele - aziqambele
uqqhuba - uqhuba
liyyohlale - liyohlale
nohlku - nohlu
oyolandella - oyolandela
esesondfelene - esesondelene
Esinmye - Esinye
abahnumusha - abahumusha
owayesehlalle - owayesehlale
sednse - sense
ezishyicilelwe - ezishicilelwe
aqkayazi - akayazi
Wenqazba - Wenqaba
esedllule - esedlule
nokwebgiwa - nokwebiwa
ubunyolnico - ubunyonico
kuMMpande - kuMpande
eziuthile - ezithile
elaklhe - elakhe
ezinbdlebeni - ezindlebeni
yibandela - yibandla
insimbgi - insimbi
azbanewabo - abanewabo
owawubhokiile - owawubhokile
anmgamvaleli - angamvaleli
luzookwandisa - luzokwandisa
Basebenezinhylelo - Basebenezinhlelo
kubuyhe - kubuye
eluise - eluse
zxasekelwa - zasekelwa
yezionto - yezinto
izakhnela - izakhela
ayyegqamile - ayegqamile
nghalokhu - ngalokhu
bveyizinkulungwane - beyizinkulungwane
kuweethula - kuwethula
lulandewleke - lulandeleke
olndlekile - ondlekile
sokufundiosa - sokufundisa
kiokhona - kokhona
kusduselwa - kususelwa
sekubhalkwe - sekubhalwe
makholsi - makhosi
loiphuma - liphuma
inqwwaba - inqwaba
nomnttwana - nomntwana
Ngbakho - Ngakho
wayewhamba - wayehamba
qhnawe - qhawe
umfanyanma - umfanyana
bnakayise - bakayise
uMthazniya - uMthaniya
kwahlanmgana - kwahlangana
ngokolsiko - ngokosiko
waytegcizelela - wayegcizelela
abnalande - abalande
owasyenesihluku - owayenesihluku
kuubuse - kubuse
esehlaseelwa - esehlaselwa
mlaqndo - mlando
kujkaShaka - kukaShaka
newmikhuba - nemikhuba
ukluzazi - ukuzazi
akayobabizaela - akayobabizela
yayizomshgiya - yayizomshiya
kangakasnani - kangakanani
kungasaheshe - kungasheshe
Kuzokhumnbuleka - Kuzokhumbuleka
kubvonakale - kubonakale
ukwakhja - ukwakha
kubandakanyta - kubandakanya
eyuelama - eyelama
pphesheya - phesheya
ethgimula - ethimula
ngeyookuba - ngeyokuba
yesizwqe - yesizwe
aziuwudlanga - aziwudlanga
uzokwethjulwa - uzokwethulwa
Ukuphiklisa - Ukuphikisa
segbama - segama
iikhuluma - ikhuluma
ollokhu - olokhu
lokuthyola - lokuthola
namnanje - namanje
lunikleze - lunikeze
ehlaziyta - ehlaziya
ezinkomenbi - ezinkomeni
abaqsaphila - abasaphila
nbgokumbona - ngokumbona
nokuivezwa - nokuvezwa
saikhule - sikhule
sikasHulumeni - sikaHulumeni
yiizwe - yizwe
naswesihlokweni - nasesihlokweni
ukuqophya - ukuqopha
werzwe - wezwe
sathgatha - sathatha
uDinizuylu - uDinizulu
elliwubuningi - eliwubuningi
ibabuulala - ibabulala
namuhloa - namuhla
kwemjibhalo - kwemibhalo
etthu - ethu
eethi - ethi
bethatthwa - bethathwa
baseNHingizimu - baseNingizimu
waswiwa - wasiwa
ibabuzaa - ibabuza
ukubazkhokhela - ukubakhokhela
seziobuzwa - sezibuzwa
ewsinelwa - esinelwa
kabnili - kabili
othangwenmi - othangweni
eekulungisweni - ekulungisweni
Wasetghumela - Wasethumela
wukuthji - wukuthi
owaphuyma - owaphuma
uzxale - uzale
ukuqahakambisa - ukuqhakambisa
okuzohlaziyywa - okuzohlaziywa
yyayithatha - yayithatha
inkolerlo - inkolelo
nasesahlukwweni - nasesahlukweni
noSikhgombazana - noSikhombazana
esxiphila - esiphila
isukje - isuke
amaphuzau - amaphuzu
nbgobuciko - ngobuciko
likhyona - likhona
baqbecindezelwe - babecindezelwe
ngezinbgxoxo - ngezingxoxo
beyobnona - beyobona
NHakwaZulu - NakwaZulu
abvabengafundile - ababengafundile
ezioqinileyo - eziqinileyo
engabhyali - engabhali
ewngabhale - engabhale
ezxitheni - ezitheni
owenzxa - owenza
amelekelkele - amelekelele
Ngednyanga - Ngenyanga
eziubhaliwe - ezibhaliwe
owazwungekho - owawungekho
azwabulale - awabulale
sesenzasamunttu - sesenzasamuntu
zigodukla - zigoduka
ezihllelela - ezihlelela
esinollimi - esinolimi
wayezawana - wayezwana
NBgaphezu - Ngaphezu
ekwalusenbi - ekwaluseni
yayisinamandcla - yayisinamandla
equibuka - equbuka
ukuwenekiela - ukuwenekela
ngokubaluledka - ngokubaluleka
ukuvbusa - ukuvusa
ongumkhuilumeli - ongumkhulumeli
kkwezahluko - kwezahluko
idayarfi - idayari
ngayiophi - ngayiphi
walotshollwa - walotsholwa
nokkuhlangana - nokuhlangana
Kubonazkele - Kubonakele
layobgamba - layobamba
lokulkoba - lokuloba
yaytitshele - yayitshele
enzaiwe - enziwe
lokuvikedlwa - lokuvikelwa
edsebenza - esebenza
sasiwakhyelwe - sasiwakhelwe
ekutyhatheni - ekuthatheni
yavedza - yaveza
iyinikezxa - iyinikeza
Wapphuma - Waphuma
udlliwe - udliwe
amazxwe - amazwe
iNdlonhdlo - iNdlondlo
ezersabekayo - ezesabekayo
wendclu - wendlu
Bonkle - Bonke
kubuyiuswa - kubuyiswa
inhdoda - indoda
kujyinto - kuyinto
okufanhele - okufanele
bgungeke - bungeke
sebebazlekile - sebebalekile
ukujlekelela - ukulekelela
ukubvuyiselwa - ukubuyiselwa
owayesengtumfana - owayesengumfana
isiofaniso - isifaniso
noMntwqana - noMntwana
awaqhambanga - awahambanga
Zuylu - Zulu
elokubuilala - elokubulala
yawuguqaula - yawuguqula
seSillo - seSilo
izangopma - izangoma
elenzaiwa - elenziwa
bendslondlo - bendlondlo
nomdclandla - nomdlandla
yayioncike - yayincike
sokuqalla - sokuqala
sxesifaniso - sesifaniso
Nasmuhla - Namuhla
ngboludala - ngoludala
ngtethole - ngethole
luuncike - luncike
ezokhaqlela - ezokhalela
abambulalerla - abambulalela
kaMbolzana - kaMbozana
eseklhulile - esekhulile
oiluyimali - oluyimali
nserlelo - nselelo
ulondoloziiwe - ulondoloziwe
iyibhjekisa - iyibhekisa
kunguyedna - kunguyena
emaNgisinbi - emaNgisini
bassigudluze - basigudluze
ehlabanhile - ehlabanile
imjbangela - imbangela
esewyintsha - eseyintsha
aweziondawo - awezindawo
izaiyalo - iziyalo
Ukubujyiselwa - Ukubuyiselwa
nemipphumela - nemiphumela
enzaima - enzima
kokuimpheka - kokumpheka
lioka - lika
wayuobhunga - wayobhunga
kunendslela - kunendlela
becaqbanga - becabanga
wababghali - wababhali
nabgakwaSibiya - nabakwaSibiya
loimi - limi
ukiuthini - ukuthini
yokuiba - yokuba
simfvanele - simfanele
wetyhulwa - wethulwa
UMasiphuula - UMasiphula
beqammba - beqamba
ziikhombisa - zikhombisa
ukwamukelleka - ukwamukeleka
nangaphamnbili - nangaphambili
Zamakhoswi - Zamakhosi
Esikhathgini - Esikhathini
imnibandela - imibandela
asehluiliwe - asehluliwe
eliubuthwa - elibuthwa
ulichazaa - ulichaza
nasesigodlwedni - nasesigodlweni
uNMkosi - uNkosi
eyinsikia - eyinsika
eseNMingizimu - eseNingizimu
ngokubakhjahla - ngokubakhahla
Ngfenzeni - Ngenzeni
okuphiondwayo - okuphindwayo
ewlithambile - elithambile
iwetyhulile - iwethulile
wawuifaka - wawufaka
ziikhona - zikhona
opkuthandwa - okuthandwa
ebitthintana - ebithintana
Inhgliziyo - Inhliziyo
iyibonmgele - iyibongele
idindilikza - idindiliza
lalliloba - laliloba
ayezobulkala - ayezobulala
yokuzaimuka - yokuzimuka
owesabekasyo - owesabekayo
baliubeka - balibeka
ezaake - ezake
kwakuungukumyengela - kwakungukumyengela
nookwezizwe - nokwezizwe
Ukuufa - Ukufa
Inbgonyama - Ingonyama
zingasbambi - zingabambi
mhllola - mhlola
bgehlala - behlala
iqhjela - iqhela
Washintswha - Washintsha
Babebalulekikle - Babebalulekile
yiswimo - yisimo
siyakhanyha - siyakhanya
noMathunbjana - noMathunjana
Okwaqkwenzeka - Okwakwenzeka
yincwadsi - yincwadi
kwakuyyikuthi - kwakuyikuthi
kugcizelewlwe - kugcizelelwe
esiyisizwee - esiyisizwe
baluphnothula - baluphothula
yokuklhohlakala - yokukhohlakala
ingaganmile - ingaganile
lwamagfama - lwamagama
ebuzwenhi - ebuzweni
eqophewlweni - eqophelweni
lipohophoza - liphophoza
ibhekelkela - ibhekelela
ezxazakhe - ezazakhe
esethaqtha - esethatha
ulookhu - ulokhu
Bhekuzullu - Bhekuzulu
ngbamazwi - ngamazwi
wahalakaqshela - wahalakashela
owasyihlasela - owayihlasela
engfaphili - engaphili
kkufakwe - kufakwe
uymSuthu - umSuthu
bazowenhze - bazowenze
insellelo - inselelo
Uyiilungu - Uyilungu
wayibulalkela - wayibulalela
kazsizwa - kasizwa
sekuikhomba - sekukhomba
impuymelelo - impumelelo
kulollo - kulolo
engabulawangta - engabulawanga
baklhe - bakhe
nhoveli - noveli
nguNdunaqnkulu - nguNdunankulu
ngihlaznganise - ngihlanganise
WWayengakhohliwe - Wayengakhohliwe
yehgluleka - yehluleka
eziyincxwadi - eziyincwadi
ekujkwazini - ekukwazini
iyokhonzxa - iyokhonza
abakwenzaqyo - abakwenzayo
zifundeisa - zifundisa
kugxiloe - kugxile
esdasingcoliswe - esasingcoliswe
sekukhoptheme - sekukhotheme
yabulaswa - yabulawa
omnmdeni - omndeni
ibaluloeke - ibaluleke
lungaqphandle - lungaphandle
isikhaqthele - isikhathele
Haqmu - Hamu
sisukje - sisuke
umzabnalazo - umzabalazo
kusekelowa - kusekelwa
Kuykho - Kukho
nelikaCetshjwayo - nelikaCetshwayo
ingawulandeeli - ingawulandeli
eziktholakala - ezitholakala
lakwaZzulu - lakwaZulu
isicedfe - isicefe
ayebaqnga - ayebanga
uuMandulo - uMandulo
iswiyedlula - isiyedlula
usekhohlwse - usekhohlwe
asgxeke - agxeke
mnakube - makube
neenkosi - nenkosi
kwempoi - kwempi
nhgamaqiniso - ngamaqiniso
yayiwathathya - yayiwathatha
okuwuikuthumela - okuwukuthumela
sewkuba - sekuba
Abaqaqlanga - Abaqalanga
uninbakazi - uninakazi
Kunikeezwe - Kunikezwe
izinghxenyana - izingxenyana
bubewkwe - bubekwe
zikhuluyma - zikhuluma
ebhiknca - ebhinca
okwakuzokhulkunywa - okwakuzokhulunywa
nangedsikhathi - nangesikhathi
yagulla - yagula
lazpho - lapho
Ngapohandle - Ngaphandle
eyokuigcina - eyokugcina
nobuqhnawe - nobuqhawe
okwazdala - okwadala
inklampani - inkampani
bangasahiyi - bangashiyi
evullela - evulela
SAizwa - Sizwa
kjuyisisekelo - kuyisisekelo
bephewndulana - bephendulana
eesigodini - esigodini
sezahunyushelowa - sezahunyushelwa
yioshwa - yishwa
maqwede - maqede
zidlulikswa - zidluliswa
isiucelo - isicelo
Kungbasiza - Kungasiza
eklugcizeleleni - ekugcizeleleni
uyakubaqlula - uyakubalula
Ukujhlaselwa - Ukuhlaselwa
esimnweni - esimweni
phezuulu - phezulu
egqaugquzelwa - egqugquzelwa
egqugquzelwee - egqugquzelwe
akethembni - akethembi
yasenhdlunkulu - yasendlunkulu
yuenza - yenza
ekunqobeeni - ekunqobeni
waytenonya - wayenonya
ytayike - yayike
Wakhja - Wakha
ayedbhale - ayebhale
Isihyluku - Isihluku
kusetshenmziswe - kusetshenziswe
sebehylanganisa - sebehlanganisa
ogikbeni - ogibeni
luyaveezwa - luyavezwa
kubabhaqli - kubabhali
esasibuswwa - esasibuswa
yinhgxenye - yingxenye
wayesebernzisa - wayesebenzisa
ilutthola - iluthola
erzimnyama - ezimnyama
Ngangibhalke - Ngangibhale
asmehlo - amehlo
eziulandela - ezilandela
wqakuzwa - wakuzwa
wayikbona - wayibona
yazihambvela - yazihambela
ukuchgukuluza - ukuchukuluza
ehlleleke - ehleleke
yalesdo - yaleso
ubumnqoka - ubumqoka
esdahlasela - esahlasela
unmgena - ungena
kjwehlulwa - kwehlulwa
ukulethja - ukuletha
newminye - neminye
ukluphilisana - ukuphilisana
Wayekuphiukisa - Wayekuphikisa
unhgeke - ungeke
bezibguza - bezibuza
ukkuthatha - ukuthatha
iiziphathimandla - iziphathimandla
njengbemfundiso - njengemfundiso
kuhlanmgana - kuhlangana
yaleezo - yalezo
sersike - sesike
lwalludla - lwaludla
lesione - lesine
Wasphumelela - Waphumelela
Abaqlingiswa - Abalingiswa
ozopbagwaza - ozobagwaza
webnutho - webutho
siibheke - sibheke
seesine - sesine
kaMMenzi - kaMenzi
buqhathanisdwa - buqhathaniswa
ngoikusika - ngokusika
ermsakazweni - emsakazweni
ezingazmagugu - ezingamagugu
ibonazkala - ibonakala
wayyezocela - wayezocela
Basukja - Basuka
lamadolda - lamadoda
Usunbgulo - Usungulo
Lokku - Loku
esebhekjene - esebhekene
labazkwaZulu - labakwaZulu
ahloasela - ahlasela
imayelkana - imayelana
ioyini - iyini
kuqoqwea - kuqoqwa
ukuhjlupheka - ukuhlupheka
ababenmgayifiseli - ababengayifiseli
okuingenzeka - okungenzeka
uzobathetthisa - uzobathethisa
aqalka - aqala
eziknkondlo - ezinkondlo
eyabno - eyabo
kunalabva - kunalaba
ngentgambo - ngentambo
basebeenze - basebenze
iwsuhlobo - iwuhlobo
phephabhyuku - phephabhuku
Abalingfisi - Abalingisi
ezigodelweni - ezigodlweni
ashiontshe - ashintshe
Isxiziba - Isiziba
ulwandlle - ulwandle
yabanikieza - yabanikeza
solkubonga - sokubonga
eyayiknqume - eyayinqume
indlunkulou - indlunkulu
oiqoqa - oqoqa
oluynothile - olunothile
kungbumntwana - kungumntwana
Ukukhippha - Ukukhipha
eduzanme - eduzane
aqbasawazi - abasawazi
alkwe - alwe
okuyisonasxona - okuyisonasona
bvaxoxe - baxoxe
walliphothula - waliphothula
zaloplu - zalolu
ngesewhlo - ngesehlo
eyayenziiwa - eyayenziwa
umzammo - umzamo
yacaciosa - yacacisa
oiwawubulala - owawubulala
Sheepstone - Shepstone
inkosazazna - inkosazana
uukhetha - ukhetha
embgangweni - embangweni
iyogcxina - iyogcina
yayisebenziswa - yayisebenzisa
ukuchithneka - ukuchitheka
ayiphgumelelanga - ayiphumelelanga
yadideiyela - yadidiyela
liphummule - liphumule
olusezxingeni - olusezingeni
umnlenze - umlenze
kjobuciko - kobuciko
ewzobona - ezobona
uqahathanisa - uqhathanisa
ngiowubone - ngiwubone
evbezwa - evezwa
lalikkhuluma - lalikhuluma
bakhaqle - bakhale
ikfihle - ifihle
uDiungana - uDingana
wayengumelanyaniswsa - wayengumelanyaniswa
wayenesinekje - wayenesineke
bazitghola - bazithola
eziunamandla - ezinamandla
nedyaseNatal - neyaseNatal
seshuminanmhlanu - seshuminanhlanu
kokhonzxa - kokhonza
weayengesona - wayengesona
amakkhathuni - amakhathuni
kwathjolakala - kwatholakala
elisenyakathjo - elisenyakatho
luqhathanhise - luqhathanise
seliivusa - selivusa
kumelwee - kumelwe
eyayhimkhulise - eyayimkhulise
uyakufakazelka - uyakufakazela
kwakungeyokjuqhakambisa - kwakungeyokuqhakambisa
nonkke - nonke
okuyiyyo - okuyiyo
eseyibophnele - eseyibophele
kubafunmdi - kubafundi
abalekeele - abalekele
abebehamnbe - abebehambe
inhento - inento
luphgathelene - luphathelene
zesiozwe - zesizwe
nhtombazane - ntombazane
seyazxiwa - seyaziwa
ukugwqema - ukugwema
ayishinmtshashintshe - ayishintshashintshe
swabo - sabo
sabva - saba
phephandeaba - phephandaba
sedbezibulalela - sebezibulalela
kweabonakala - kwabonakala
kaKhaqbazela - kaKhabazela
wayengabathanmdi - wayengabathandi
usebenmzisa - usebenzisa
bazoqoqaa - bazoqoqa
bedluleloa - bedlulela
sewbakhe - sebakhe
yawqela - yawela
emashyumini - emashumini
bangakwazzi - bangakwazi
luyoikwehlela - luyokwehlela
newlithi - nelithi
UThuylwane - UThulwane
abuiya - abuya
ukwehlujkanisa - ukwehlukanisa
umswuka - umsuka
izolba - izoba
kunazlowo - kunalowo
waqyidonda - wayidonda
engenbhla - engenhla
nesiphetgho - nesiphetho
lukhunhi - lukhuni
kuNtuliklazi - kuNtulikazi
ayigingqae - ayigingqe
ekuhgloleni - ekuhloleni
yayicdela - yayicela
yabefdundisi - yabefundisi
lukhnulu - lukhulu
isimisaelo - isimiselo
okuyinhdawo - okuyindawo
lwqenkosi - lwenkosi
Babulalka - Babulala
kaMapphitha - kaMaphitha
nobunbtu - nobuntu
Kuloawo - Kulawo
lomkhyandlu - lomkhandlu
belakjanyana - belakanyana
ayenhgaphezulu - ayengaphezulu
esaeqhwaga - eseqhwaga
Kuyavcela - Kuyavela
zashicilelwea - zashicilelwa
abvaliwe - abaliwe
ikhottheme - ikhotheme
yaqbangwa - yabangwa
umyueni - umyeni
zkigxile - zigxile
esethulkweni - esethulweni
uzalelanbi - uzalelani
yamaBhunmu - yamaBhunu
kiubuyelwe - kubuyelwe
yabuimba - yabumba
sdazi - sazi
olkubhekwana - okubhekwana
uBhekuzulku - uBhekuzulu
lezikthole - lezithole
yoMJntwana - yoMntwana
wasiiphisela - wasiphisela
yayyivezwe - yayivezwe
eezwa - ezwa
babengasemnandci - babengasemnandi
ukuhlaneklezeleka - ukuhlanekezeleka
izopbakhethela - izobakhethela
mmanje - manje
olwazi - owazi
neziphgathimandla - neziphathimandla
saqmhlonipha - samhlonipha
bazfundisi - bafundisi
ujmehlisa - umehlisa
edlelwseni - edlelweni
iinceku - inceku
banbolwazi - banolwazi
awubonbe - awubone
umjama - umama
kungabni - kungabi
ungivikedle - ungivikele
ntekenhteke - ntekenteke
abanesifisxo - abanesifiso
zokwehluileka - zokwehluleka
yagtana - yagana
obenzxa - obenza
oxoxzela - oxoxela
kobnukhosi - kobukhosi
yethya - yetha
zithatthe - zithathe
njkengasekhasini - njengasekhasini
abashga - abasha
iufuna - ifuna
Kuyuabonakala - Kuyabonakala
bezxosala - bezosala
okuninbgi - okuningi
Kuulabo - Kulabo
oluphazthekayo - oluphathekayo
nowayhesilindele - nowayesilindele
Wasseluthwala - Waseluthwala
ugciina - ugcina
namaqseko - namaseko
amaqinbiso - amaqiniso
sabuyza - sabuza
ayiniukeza - ayinikeza
isigaqmeko - isigameko
wazkhipha - wakhipha
okkwakhiwa - okwakhiwa
ewalasndela - ewalandela
yazyiphenya - yayiphenya
ebujlalana - ebulalana
ubabga - ubaba
mugqwa - mugqa
kwagxilwwa - kwagxilwa
inhikezwa - inikezwa
abnangawuthobeli - abangawuthobeli
abaneendeni - abanendeni
mdlaloo - mdlalo
latyhatha - lathatha
eyazso - eyaso
samjemukela - samemukela
ababhasla - ababhala
ukubullala - ukubulala
olujmabala - olumabala
esasesaizinqobile - esasesizinqobile
enhqotshiwe - enqotshiwe
owayekazde - owayekade
nibvabulale - nibabulale
mbhasli - mbhali
lezinhyla - lezinhla
kwabazxibonele - kwabazibonele
lathyi - lathi
yiisenzo - yisenzo
sinbjalo - sinjalo
olukwezinbye - olukwezinye
bukaNdleela - bukaNdlela
ngumunttu - ngumuntu
kiwethulwa - kwethulwa
ungowendlku - ungowendlu
kaSilwazne - kaSilwane
yazlolu - yalolu
ibvatshela - ibatshela
ababuthelwwe - ababuthelwe
owakwenhu - owakwenu
esezobabuzxa - esezobabuza
imtshedla - imtshela
wayeyindodanba - wayeyindodana
kwahlazaiywa - kwahlaziywa
lookuba - lokuba
umjfundisi - umfundisi
ukuubuya - ukubuya
eyaytinobungani - eyayinobungani
umchaqza - umchaza
Iphjephandaba - Iphephandaba
isakhiuwo - isakhiwo
ytayisinempi - yayisinempi
kabaqze - kabaze
imthumnba - imthumba
inmkonyane - inkonyane
ngomunyhe - ngomunye
wamnbcoma - wamncoma
iphiila - iphila
azyeyibamba - ayeyibamba
kokulunjhwa - kokulunjwa
ngokufga - ngokufa
sekuzobhnekwa - sekuzobhekwa
kwabaqcacela - kwabacacela
yayinommbono - yayinombono
kwamadeodana - kwamadodana
akubvuze - akubuze
eyasenzxa - eyasenza
zopkuqoqa - zokuqoqa
edzisetshenziswe - ezisetshenziswe
ngeeyoMntwana - ngeyoMntwana
ngoikubi - ngokubi
ayenazwo - ayenawo
Walithathelewla - Walithathelela
wedsibalo - wesibalo
yokuyqamba - yokuqamba
abangamasshumi - abangamashumi
emsebenzaini - emsebenzini
buhlle - buhle
wayishayya - wayishaya
nghukunweba - ngukunweba
ivuklwa - ivukwa
wednoveli - wenoveli
ezahloukeneyo - ezahlukeneyo
Laphno - Lapho
ukhuthjazwe - ukhuthazwe
avikewla - avikela
avikeloe - avikele
kuNnandi - kuNandi
enguimendo - engumendo
Laspha - Lapha
edoplobheni - edolobheni
ezaqndleni - ezandleni
enyyathi - enyathi
ikbasole - ibasole
kulaqndelwa - kulandelwa
Baqziswa - Baziswa
yyamadodana - yamadodana
Usebnenzisa - Usebenzisa
oobonga - obonga
ngokulingbanayo - ngokulinganayo
koldwa - kodwa
ezigaberni - ezigabeni
nezinkiomo - nezinkomo
uymbumbi - umbumbi
jewnali - jenali
Ngfokuwazi - Ngokuwazi
wamakhosai - wamakhosi
izinqae - izinqe
ezifanbayo - ezifanayo
enbgezile - engezile
ngemaqmba - ngemamba
embasndakanya - embandakanya
idedellwe - idedelwe
izxinto - izinto
luqhubekke - luqhubeke
nombvuzo - nombuzo
ulaqka - ulaka
Masthela - Mathela
zisemqaoka - zisemqoka
olunhamagwegwe - olunamagwegwe
owayeyinyangba - owayeyinyanga
ayedmthanda - ayemthanda
Yinoveeli - Yinoveli
akulobva - akuloba
waphewlela - waphelela
eemfushane - emfushane
owayyemhlophe - owayemhlophe
olqamba - oqamba
kushiyanha - kushiyana
anbgalandeli - angalandeli
klungathiwa - kungathiwa
wayehjlobene - wayehlobene
qwhinga - qhinga
nokuzwakaloayo - nokuzwakalayo
oweenziwe - owenziwe
nohlobvo - nohlobo