unguMkhululi - inguMkhululi
leelula - ledlula
rhina - thina
eyayizithoklzisa - eyayizithokozisa
kuyinklsi - kuyinkosi
xiyatshengisa - ziyatshengisa
okiyinoveli - okuyinoveli
ombokodwe - imbokodwe
nslowo - nalowo
hkunzi - nkunzi
wasemausa - wasemsusa
zifiie - zifike
ayiqindanga - ayiqondanga
nfamaNgisi - ngamaNgisi
lingzdluliselwanga - lingadluliselwanga
atyola - athola
zokybusa - zokubusa
wayekqazi - wayekwazi
esedazuljka - esedazuluka
abszithandanga - abazithandanga
wymthetho - wumthetho
kzthathu - kathathu
Wsyenokuwabuka - Wayenokuwabuka
izonuye - izobuye
bsvukwe - bavukwe
hepolitiki - nepolitiki
uSonantu - uSobantu
uMmtwana - uMntwana
ngokwemiyslelo - ngokwemiyalelo
kukaMbuyaxi - kukaMbuyazi
ehokwenanyelwa - eyokwenanyelwa
Wane - Wabe
ibahlabe - ubahlabe
kokuyhatha - kokuthatha
okusrkhona - okusekhona
njrngesithakazelo - njengesithakazelo
bunkpndlo - bunkondlo
ayessba - ayesaba
ebukjosini - ebukhosini
edize - eduze
angabilali - angabulali
mgiphumelele - ngiphumelele
esichigha - esichitha
kwrsigodlo - kwesigodlo
kaxange - kazange
olakrni - olakeni
ehhovksi - ehhovisi
umllmo - umlomo
zazihaysa - zazihaywa
yabcama - yancama
elisesajlukweni - elisesahlukweni
iNinhizimu - iNingizimu
yzkhala - yakhala
kwahde - kwande
emninti - emningi
okwenzela - okwenzeka
ksikhathi - isikhathi
kyNdlunkulu - kuNdlunkulu
ayuswe - ayiswe
ecathaja - ecathama
kwasuja - kwasuka
oophiko - lophiko
usiza - isiza
bako - balo
luyathuthukiwwa - luyathuthukiswa
wyiqhawe - eyiqhawe
lubyekene - lubhekene
akage - akabe
iwezinyanga - kwezinyanga
obybi - obubi
yamagubu - yamagugu
wrsiko - wesiko
ngobukhoxi - ngobukhosi
ujuhlolwa - ukuhlolwa
nase - base
okuwakhaho - okuwakhayo
baphonwa - baphonsa
bapjiwe - baphiwe
uendoda - yendoda
nabatnile - nabathile
kambuyazwe - kaMbuyazwe
namznoveli - namanoveli
nsngezinkomo - nangezinkomo
abamlonde - abamlinde
kwaziae - kwazise
bsze - baze
Mphumempimi - Mphumempini
ebhaoe - ebhale
Ngrlanga - Ngelanga
afezwa - avezwa
sayeqhuba - wayeqhuba
Mbulaai - Mbulazi
osiko - isiko
aasivusa - sasivusa
uNomatshzli - uNomatshali
ngdnhla - ngenhla
iwabhdka - iwabheka
zisitxhele - zisitshele
ekubhodlizweni - ekubhidlizweni
ubula - ubuka
zizeakale - zizwakale
nabefundiai - nabefundisi
ekutholakaldni - ekutholakaleni
iwiphetho - isiphetho
nhokutshalwa - ngokutshalwa
hahlasela - yahlasela
Inhlehlanyovabe - Inhlehlanyovane
nobinkondlo - nobunkondlo
ababehlonidhwa - ababehlonishwa
bomfowabo - nomfowabo
yalhetha - yakhetha
okjvela - okuvela
yezwaksla - yezwakala
kujhulunya - kukhulunya
yamadoeakazi - yamadodakazi
nasesigamekwrni - nasesigamekweni
kwabsnye - kwabanye
ukutcwaliselwa - ukugcwaliselwa
abanlbuciko - abanobuciko
lihleowa - lihlelwa
ayinange - ayibange
yrna - yena
kwenhlangamo - kwenhlangano
owaywqhamuka - owayeqhamuka
ezonzulwini - ezinzulwini
omunte - omunye
nebsila - nensila
qkavumi - akavumi
hgezwi - ngezwi
ufakqzi - ufakazi
Lokjo - Lokho
Lojhu - Lokhu
ayengongqoshishiliai - ayengongqoshishilizi
begulalana - bebulalana
ekuhlanelezeleni - ekuhlanekezeleni
mobani - nobani
waszla - wasala
qgcine - agcine
kwagcwaliwela - kwagcwalisela
zingalandelahiswa - zingalandelaniswa
ukuyomwma - ukuyomema
okutholqkele - okutholakele
wanuthatha - wabuthatha
eszsiwathume - esasiwathume
Kuzwakaka - Kuzwakala
ukjkhoseliswa - ukukhoseliswa
qkwenzeki - akwenzeki
emaihosini - emakhosini
Wasula - Wasuka
geyilalele - beyilalele
ntaphambilini - ngaphambilini
sugameko - sigameko
adiciyela - adidiyela
izincaaelo - izincazelo
wztheswa - watheswa
ungzyithatha - ungayithatha
Izimbohgi - Izimbongi
emasokweni - emasikweni
pwayenza - owayenza
mphakatni - mphakathi
nfokukaZulu - ngokukaZulu
okungahlahgani - okungahlangani
keesinye - kwesinye
isilulo - isililo
ingezwabi - ingezwani
izigake - izifake
adinba - adinga
ayeuiphethe - ayeyiphethe
xiwethula - ziwethula
yasitji - yasithi
nasebukhosoni - nasebukhosini
xemibango - zemibango
UMaheba - UMageba
uzophuna - uzophuma
aodwa - sodwa
Wasunda - Wasinda
ewicacile - esicacile
yokughaliwe - yokubhaliwe
iminyskazo - iminyakazo
Uiugcizelela - Ukugcizelela
kubanjqa - kubanjwa
umibuso - imibuso
yasentdhonalanga - yasentshonalanga
syebekwe - ayebekwe
baluntuza - balunguza
ngomhlahgano - ngomhlangano
Kingabe - Kungabe
kusenesiihala - kusenesikhala
siphinfa - siphinda
ekuvuja - ekuvuma
ibalide - ibalise
xayihlomisa - sayihlomisa
uhazi - ugazi
womlahdo - womlando
abengalaze - abengakaze
Inkosaxana - Inkosazana
iseburhweni - isebuthweni
ibuhle - ubuhle
abambuleldyo - abambuleleyo
okhulu - ikhulu
womjntu - womuntu
unngcele - umngcele
esefunce - esefunde
kwezindyna - kwezinduna
ngangilythole - ngangiluthole
Sejuphawuliwe - Sekuphawuliwe
kseziphuku - kweziphuku
satohlasela - sayohlasela
ujuthi - ukuthi
ukunaleka - ukubaleka
kunexinye - kunezinye
kwalqa - kwalwa
kwakunguyiwe - kwakunguyise
unchwayo - umchwayo
wayrzocelela - wayezocelela
sfuna - afuna
yagciba - yagcina
nezinpendulo - nezimpendulo
ebesethuka - ebesethula
ngamaNtunfwa - ngamaNtungwa
ezwqna - ezwana
aaoba - azoba
ehonele - enonele
ungaqhubeka - ingaqhubeka
oqayehamba - owayehamba
bedlilisa - bedlulisa
lonle - lonke
owayemgudadewabo - owayengudadewabo
Iziawe - Izizwe
okwenzekauo - okwenzekayo
yanopha - yabopha
ukubikela - ukuvikela
ngumdhoboko - ngumchoboko
bsganwe - baganwe
iniosikazi - inkosikazi
bazunheza - bazungeza
yaneise - yandise
sndise - andise
kwabjalwa - kwabhalwa
umubtu - umuntu
mgokulandelana - ngokulandelana
wana - waba
okwszi - okwazi
ikwabhalwa - okwabhalwa
kuSobanru - kuSobantu
apgike - aphike
ngimsindo - ngomsindo
inkuljmo - inkulumo
iphaksthi - iphakathi
nabenboni - nabemboni
genza - benza
izimgwazi - izingwazi
wmva - emva
waka - wala
washicilrla - washicilela
babulaqelwa - babulawelwa
ayeholsa - ayeholwa
webcwadi - wencwadi
ukingacaci - ukungacaci
qvela - avela
ngunaba - ngubaba
exobuzwa - ezobuzwa
akjvami - akuvami
wake - wale
esenaeka - esenzeka
neyqba - neyaba
okuphokisana - okuphikisana
uyunyosi - uyinyosi
ngokwqmasiko - ngokwamasiko
isiqslekiso - isiqalekiso
sahokuma - sayokuma
Unaveze - Ubaveze
zobukhpsi - zobukhosi
ngezindzwo - ngezindawo
bengizimbulala - bengizombulala
yskhuluma - yakhuluma
ukukubaljla - ukukubalula
lzso - laso
Nsaba - Ndaba
abaseiho - abasekho
ojwakunzima - okwakunzima
vephepha - bephepha
ayinhenyiswe - ayinyenyiswe
kuwukwenaa - kuwukwenza
Ukushumana - Ukuxhumana
owawukwaMthetjwa - owawukwaMthethwa
sdkubamba - sekubamba
mgapha - ngapha
ziyovana - ziyofana
kwskhe - kwakhe
waao - wazo
kwakjo - kwakho
lsze - laze
ksaleso - kwaleso
yenzise - yenziwe
ikwazothi - okwazothi
kunamawiniso - kunamaqiniso
azothpla - azothola
enhabuzwa - engabuzwa
kwakukqde - kwakukade
evuoelekile - evulelekile
okwsba - okwaba
nandulo - mandulo
kngathathwa - ingathathwa
owatethi - owayethi
umjhumbi - umkhumbi
sepoliriki - sepolitiki
ehana - egana
Mhka - Mhla
etama - egama
ibgakhulumi - ingakhulumi
yavuleia - yavuleka
lwenzelwa - kwenzelwa
kokubuwa - kokubusa
yasdNatali - yaseNatali
zinhama - zingama
jubanikazi - kubanikazi
bebanba - bebanga
abangzbalulekile - abangabalulekile
ohlanfothini - ohlangothini
singetena - singeyena
lezindlwla - lezindlela
Kelo - Lelo
amathatnu - amathathu
Jyinkosi - Uyinkosi
owayenhomunye - owayengomunye
iusiza - kusiza
elqbanjwa - elabanjwa
akatholznga - akatholanga
njengeqnawe - njengeqhawe
Kutjolakele - Kutholakele
menani - nenani
eziwebzayo - eziwenzayo
eliseyshenziswa - elisetshenziswa
noMkhumbijazulu - noMkhumbikazulu
kwanijeza - kwanikeza
iaibongo - izibongo
bangalahlekrlwa - bangalahlekelwa
ekwenzebi - ekwenzeni
ukuzsa - ukuzwa
zinkonhane - zinkonjane
kunobuqibiso - kunobuqiniso
waydseyitshela - wayeseyitshela
ybuza - ubuza
Iwiko - Isiko
absbeluthola - ababeluthola
unuzi - umuzi
wokuthombulula - sokuthombulula
kukaNomabtshali - kukaNomantshali
lokugxeia - lokugxeka
lungaqulwanga - lingaqulwanga
Sekuzoqhathanidwa - Sekuzoqhathaniswa
ohlakanipgile - ohlakaniphile
yabqoba - yanqoba
idinbida - idingida
Amakhosokazi - Amakhosikazi
nokilondolozwa - nokulondolozwa
ngokuxoxeowa - ngokuxoxelwa
lukzNgoza - lukaNgoza
bebhqla - bebhala
kushingsha - kushintsha
ngokubuyhwa - ngokubuthwa
isihehlule - isiyehlule
smaqhinga - amaqhinga
esilungwuni - esilungwini
infavumanga - ingavumanga
okeaziwa - okwaziwa
lokibekwa - lokubekwa
olutholakqlayo - olutholakalayo
yokuziahelelanisa - yokuziqhelelanisa
oqaqoqa - owaqoqa
yufu - yifu
wayeseylgana - wayeseyogana
gasize - basize
kusacliwa - kusadliwa
banengafuni - babengafuni
Muna - Mina
Umkyonto - Umkhonto
eswbone - esebone
dngaphiliyo - engaphiliyo
Kwayhunyelwa - Kwathunyelwa
kwakumeke - kwakumele
angaainzi - angazinzi
uwizo - usizo
yulo - yilo
umnuzo - umbuzo
xabamukayo - zabamukayo
bgamaqhawe - ngamaqhawe
imyoka - inyoka
bathuka - bathula
yihi - yini
athathea - athathwa
dilindwa - silindwa
wayesekhonbisile - wayesekhombisile
ukuhlekwa - ukuhlelwa
uphikeoele - uphikelele
angapgezu - angaphezu
Pyunga - Phunga
babengakabanwa - babengakaganwa
imbuso - umbuso
Ubuhlaiani - Ubuhlakani
ekhombusa - ekhombisa
nokubela - nokubeka
elashicklelwa - elashicilelwa
kukhooakala - kukholakala
somyzi - somuzi
ehgaphilile - engaphilile
nenhlzlo - nenhlalo
Gumwde - Gumede
bgokubalamula - ngokubalamula
Imduna - Induna
sifodlo - sigodlo
kuhlazoywa - kuhlaziywa
Ingloso - Inhloso
zewikhathi - zesikhathi
babenfaze - babengaze
nokwenqava - nokwenqaba
Ezinkondoweni - Ezinkondlweni
omibono - imibono
weSolo - weSilo
becashinwe - becashunwe
eghula - ethula
inandide - inandise
enyskatho - enyakatho
lwamaboveli - lwamanoveli
kwalzndelwa - kwalandelwa
Nglkwakhe - Ngokwakhe
owayehambosana - owayehambisana
ezenaeka - ezenzeka
maphalala - Maphalala
Akuoula - Akulula
uMavhodla - uMabhodla
nbokweshwama - ngokweshwama
Siyaxizwa - Siyazizwa
bohke - bonke
iuobona - iyobona
ngokutxeka - ngokugxeka
wokiba - wokuba
kuphqmbene - kuphambene
kwenbongi - kwembongi
bahleka - bahlela
selinlobe - selihlobe
ryokwentuleka - eyokwentuleka
npmzimba - nomzimba
ejubumbekeni - ekubumbekeni
yayinbaba - yayingaba
Lqlikhulile - Lalikhulile
shlubuka - ahlubuka
Okumkhathaaayo - Okumkhathazayo
adybule - adubule
iubhekwa - kubhekwa
ukutjandana - ukuthandana
kukaMalzndela - kukaMalandela
bazisqe - baziswe
azibnala - azibhala
ngodi - ngosi
Utaqhubeka - Uyaqhubeka
ifkke - ifike
Ubumbohgi - Ubumbongi
yosakhamuzi - yisakhamuzi
eyayisetsnenziswa - eyayisetshenziswa
klnkamisa - konkamisa
yabekelsa - yabekelwa
amaluhgu - amalungu
wqyikhomba - wayikhomba
zimbandskanya - zimbandakanya
basonha - basonga
alptsholwe - alotsholwe
lungazowa - lungaziwa
myamanambana - nyamanambana
ikwengamela - ukwengamela
Ngesakge - Ngesakhe
leentsha - lwentsha
qinixo - qiniso
ibzleka - ibaleka
Zibohgo - Zibongo
zbatholakala - abatholakala
wasebenaisa - wasebenzisa
banbabokuqala - bangabokuqala
emyva - emuva
nenfaba - nendaba
qbabeshintsha - ababeshintsha
ngikubika - ngikunika
kuxonta - kusonta
okuva - okuba
eyayibhqlwe - eyayibhalwe
seskngathekiso - sesingathekiso
uahlaba - yahlaba
aekukhona - sekukhona
ngpba - ngoba
sihlanganide - sihlanganise
sesifumbu - sesidumbu
uljngisa - ulungisa
isnade - ishade
boiuzidela - bokuzidela
esdsale - esesale
baxibona - bazibona
ukukuvrza - ukukuveza
kaluyona - kakuyona
UNomawhikizela - UNomashikizela
wyolwa - eyolwa
Wayedaka - Wayefaka
amankpnyane - amankonyane
wunufakazi - wubufakazi
nelilodsa - nelilodwa
ibneke - ibheke
Engavubende - Engabubende
azinhadu - azibhadu
ayohlzsela - ayohlasela
onganileza - onganikeza
waydnezinkomo - wayenezinkomo
ngezkndaba - ngezindaba
kokuva - kokufa
kwakunwzelamani - kwakunezelamani
esiseMsvivane - esiseMavivane
ayepjelele - ayephelele
Najhona - Nakhona
eoishumi - elishumi
yayingaqaaha - yayingaqasha
isiqibiseko - isiqiniseko
vekungeyena - bekungeyena
lrli - leli
longenile - lingenile
uThulsana - uThulwana
kamhloohe - kamhlophe
ayithqndanga - ayithandanga
bgemfundisoze - ngemfundisoze
nosojahlaya - nosomahlaya
sengatyi - sengathi
Ksibhedlela - Isibhedlela
jikeleke - jikelele
abaswkhaya - abasekhaya
ihlushsa - ihlushwa
zamjka - zamuka
wehu - wenu
qyezoqopha - ayezoqopha
knxiwa - inxiwa
ngagabhali - ngababhali
wamavutho - wamabutho
ukiqonda - ukuqonda
nguMntwaba - nguMntwana
zocwaninto - zocwaningo
kwesiseielo - kwesisekelo
eaqale - waqale
wqqala - waqala
ukjmiswa - ukumiswa
zazeghula - zazethula
sebze - senze
kwezintomgi - kwezintombi
bajwaNomgabhi - bakwaNomgabhi
abakhiwhwe - abakhishwe
yayobhalwe - yayibhalwe
bathubywe - bathunywe
sejuthe - sekuthe
Avafazi - Abafazi
Kamti - Kanti
kusebenzida - kusebenzisa
elivezqe - elivezwe
eohezu - ephezu
esauethula - esayethula
umqonco - umqondo
unuthi - ubuthi
kuqsla - kuqala
ongdna - ongena
ukuknulelwa - ukukhulelwa
olynothiswe - olunothiswe
yojibili - yomibili
ezaxihaya - ezazihaya
esedluleldyo - esedluleleyo
wauelala - wayelala
kokusetxhenziswa - kokusetshenziswa
kusinikeaa - kusinikeza
ezazixhaza - ezazichaza
yazomuka - yazimuka
olupgusile - oluphusile
ubuainiso - ubuqiniso
echzzela - echazela
nabulawe - babulawe
okumeke - okumele
ajanyathelo - amanyathelo
ukiba - ukuba
gabona - babona
qayesakha - wayesakha
wzinto - ezinto
Vabemi - Babemi
intcaca - ingcaca
zabute - zabuye
ofakaxi - ofakazi
sekungarhiwa - sekungathiwa
bamlinea - bamlinda
siawa - sizwa
bethyka - bethuka
ngokuxhesha - ngokushesha
menselelo - nenselelo
kukibaleke - kulibaleke
eaixoshisa - ezixoshisa
kwemihqa - kwemigqa
okuveawe - okuvezwe
ikweshela - ukweshela
ukuqhathqniswa - ukuqhathaniswa
ithenbisile - ithembisile
wayengoqebandla - wayengowebandla
wsyenomuzi - wayenomuzi
ityatha - ithatha
matsge - matshe
rbonga - ebonga
weNgontama - weNgonyama
sekuzolahdela - sekuzolandela
wahkukanisa - wahlukanisa
wakge - wakhe
lwezkqu - lweziqu
sebto - sento
namakhosqzana - namakhosazana
ajwaziwa - akwaziwa
selubukwa - sekubukwa
wonuzwe - wobuzwe
wzmukeleka - wamukeleka
zazisadliliswa - zazisadluliswa
Kwesonye - Kwesinye
osohdelene - osondelene
babungafjndiswa - babungafundiswa
wayeyibdoda - wayeyindoda
ngexizwe - ngesizwe
bezohibona - bezoyibona
ukuzqma - ukuzama
njloso - nhloso
nabekhala - babekhala
ababepnethe - ababephethe
ehkala - ehlala
isijloko - isihloko
lakhitjika - lakhithika
sihludhwa - sihlushwa
beqqla - beqala
asabene - axabene
nbenqola - ngenqola
Keakhalwa - Kwakhalwa
kuMsndulo - kuMandulo
ayesethqtha - ayesethatha
wside - eside
kugxeja - kugxeka
naiuyo - nakuyo
yexokuvakasha - yezokuvakasha
ayixibekanga - ayizibekanga
Sasiwemalungelweni - Sasisemalungelweni
abeluhgu - abelungu
kjbuyekezwe - kubuyekezwe
inhlqwulo - inhlawulo
ugxizelela - ugcizelela
ngokqemvelo - ngokwemvelo
yaykngawaklomelisi - yayingawaklomelisi
abanlabene - abahlabene
Wayevexa - Wayeveza
wayesethymba - wayesethumba
zezzzi - zezazi
nojbango - nombango
Singquja - Singquma
selubhelene - selubhekene
beziga - neziga
Nempeka - Nempela
engasenzkwa - engasenziwa
nisinga - nosinga
esitholsa - esitholwa
ehingizimu - eningizimu
kunenkokelo - kunenkolelo
ngendlumkulu - ngendlunkulu
Wabamiwa - Wabamisa
ekiqhawe - eliqhawe
walugwaza - waligwaza
icdla - icela
Ukunqlba - Ukunqoba
abzsuselwa - abasuselwa
kwwnzakalani - kwenzakalani
inuthwa - ibuthwa
ungspheleli - ungapheleli
kaNdqba - kaNdaba
kulokyo - kulokho
ekuncikebi - ekuncikeni
ezijaywa - ezihaywa
kwamqgama - kwamagama
okungzzange - okungazange
wenyyke - wenyuke
ezingamaqiniao - ezingamaqiniso
ngdqhaza - ngeqhaza
nokuqanjea - nokuqanjwa
Uluhlabelela - Ukuhlabelela
pjepha - phepha
Ngcibo - Ngcobo
icwbo - icebo
srzindala - sezindala
Abanteana - Abantwana
Phuntashe - Phungashe
kuyawjsonta - kuyawusonta
yayibikwzela - yayibikezela
yokubjlawa - yokubulawa
ukeephula - ukwephula
ezisuaela - ezisusela
wachelelrka - wacheleleka
engqikityini - engqikithini
sebeyinlubukile - sebeyihlubukile
kudele - kusele
newigqi - nesigqi
oqeqewhiwe - oqeqeshiwe
ngamahybo - ngamahubo
bahinge - baninge
sitnathe - sithathe
isyka - isuka
isabuwa - isabusa
mahhzla - mahhala
ababwngamashumi - ababengamashumi
nelikhombusa - nelikhombisa
Kwabonalala - Kwabonakala
wezingpma - wezingoma
ekukhymbuleni - ekukhumbuleni
pyaye - oyaye
tayomele - yayomele
wokugcina - sokugcina
sskwaMbonambi - sakwaMbonambi
oksakukhona - okwakukhona
owayeboshelqe - owayeboshelwe
noMnjmzane - noMnumzane
ababeholunikeza - ababeyolunikeza
ukuyobatshrla - ukuyobatshela
owayengumfuneisi - owayengumfundisi
eyayikhukuma - eyayikhuluma
Bgoba - Ngoba
kabuhlubgu - kabuhlungu
okwatgi - okwathi
zifjndwe - zifundwe
lavamba - labamba
koluthi - kokuthi
sokusonceza - sokusondeza
USilwzne - USilwane
owayesipheneula - owayesiphendula
bepgephandaba - bephephandaba
Uiubuthwa - Ukubuthwa
baihuluma - bakhuluma
ehziwa - enziwa
bangawuthemga - bangawuthenga
aaziyini - zaziyini
moMaphitha - noMaphitha
ungekho - ingekho
sokuna - sokuba
xwaka - cwaka
busengqikitgini - busengqikithini
wazofaka - wazifaka
kungenaa - kungenza
izohlogisa - izohlobisa
homsebenzi - yomsebenzi
Nhubane - Ngubane
kyngenye - kungenye
ingakahani - ingakagani
bqyingozi - bayingozi
llgobe - logobe
Pheau - Phezu
Nzumalo - Nxumalo
azonabo - azinabo
zohldlo - zohlelo
ukuyepjuca - ukuyephuca
ukuphindaphimda - ukuphindaphinda
abakwqNxumalo - abakwaNxumalo
Kwakjbhalwe - Kwakubhalwe
iNkonhane - iNkonyane
nabamntama - nabamnyama
atsgele - atshele
luaolekelela - luzolekelela
ayksoze - ayisoze
qfikelele - afikelele
Ubahgwe - Ubangwe
swuthathwe - awuthathwe
ezincwsdini - ezincwadini
xiyaveza - ziyaveza
edhazwa - echazwa
zolwabdle - zolwandle
ukishona - ukushona
uMshole - uMahole
yoja - yoma
eyusitha - eyisitha
noja - noma
iyimgxenye - iyingxenye
ngumntwaha - ngumntwana
emnxane - emncane
nengcindezrlo - nengcindezelo
kugzilwa - kugxilwa
wesoZulu - wesiZulu
Ekubqzeni - Ekubazeni
Jing - King
ikhumnuleke - ikhumbuleke
kwaluyinkosikazi - kwakuyinkosikazi
epheoheni - ephepheni
wabyeka - wabheka
wnembile - enembile
Abzbambe - Ababambe
Namsnje - Namanje
ubdfuna - ubefuna
ingasayibobi - ingasayiboni
uyipnisi - uyiphisi
auebuye - ayebuye
Kwqkuyinoveli - Kwakuyinoveli
ababwhlakaniphile - ababehlakaniphile
Yingzlezi - Yingalezi
rnkosini - enkosini
benokuvumrlana - benokuvumelana
Umyhetho - Umthetho
ilska - ilaka
ngesasqsa - ngesasasa
wayeghanda - wayethanda
ngpnyaka - ngonyaka
othuze - othize
yanlotsholelwa - yamlotsholelwa
yisufo - yisifo
owayepheyhe - owayephethe
omnysma - omnyama
Madingana - Masingana
onamsndla - onamandla
yiwilo - yisilo
ngrzinto - ngezinto
wayezophatya - wayezophatha
kungamdiea - kungamdida
ngokwqkhe - ngokwakhe
liae - lize
sihlsngane - sihlangane
kwakungqmabutho - kwakungamabutho
rxhumene - exhumene
wapguma - waphuma
usdsebenzisa - usesebenzisa
Wayenetheaekile - Wayenethezekile
axanane - axabane
ikuvumeke - ikuvumele
osno - osho
esikhuneleni - esikhundleni
bomlzndo - bomlando
yinceba - yinxeba
ngesino - ngesimo
wayefjna - wayefuna
loyohanjwa - liyohanjwa
rwafuna - ewafuna
imininungwane - imininingwane
kocwqningo - kocwaningo
kwakusgo - kwakusho
elungwle - elungele
sasesipgikelela - sasesiphikelela
Sawuthi - Wawuthi
umnxwaningi - umncwaningi
ngommtwana - ngomntwana
ykusebenzisa - ukusebenzisa
uyawuphibda - uyawuphinda
ukugzeka - ukugxeka
eziwoqelwe - eziqoqelwe
yokuqheleoana - yokuqhelelana
esingqphelele - esingaphelele
ivabhuqe - ibabhuqe
kekubhrkwe - kekubhekwe
skbalo - sibalo
ezingamanlveli - ezingamanoveli
gamanxansukwana - gamanxandukwana
nasemazseni - nasemazweni
Imkosi - Inkosi
zombangise - zimbangise
smabutho - amabutho
ongwe - ingwe
asukwazi - awukwazi
Ezihcwadini - Ezincwadini
nomtjelela - nomthelela
ukunvipha - ukuncipha
indlalira - indlalifa
ksibaya - isibaya
unulima - ubulima
saloku - salolu
Akuvanele - Akufanele
nesugcwele - nesigcwele
njengamqhubo - njengamahubo
olwehlukule - olwehlukile
Okunguwlna - Okunguwona
iwithombe - isithombe
sabazosha - sabaxosha
zthile - athile
kidaleke - kudaleke
sekura - sekufa
zkthinta - zithinta
zgxeka - agxeka
abonakrle - abonakele
eyqphuma - eyaphuma
solukhuluma - sokukhuluma
abalingixwa - abalingiswa
entaha - entsha
otgi - othi
abahlexi - abahlezi
uMpanfazitha - uMpangazitha
uNguvane - uNgubane
angazivaki - angazifaki
sezizatyu - sezizathu
ebyekana - ebhekana
ukuvumrlana - ukuvumelana
yaswmandulo - yasemandulo
yobizwe - yobuzwe
okumgezona - okungezona
Okuyenxa - Okuyenza
owayebamgele - owayebambele
endawdni - endaweni
iuvezwe - kuvezwe
uokugcina - yokugcina
oPyunga - oPhunga
kupheoa - kuphela
wakwqSokhulu - wakwaSokhulu
owslotsholwa - owalotsholwa
Watengomunye - Wayengomunye
ajhe - akhe
batharha - bathatha
ukusnesha - ukushesha
imgafakwa - ingafakwa
kunalpkho - kunalokho
kqnzima - kanzima
yayinyzmanambana - yayinyamanambana
uzimo - izimo
vayibulala - bayibulala
neburho - nebutho
emzumi - emzimi
owafela - owavela
zaxingekho - zazingekho
Abanyu - Abantu
Wabqlekela - Wabalekela
sizipnatha - siziphatha
uydnaba - uyenaba
amabinzama - amabinzana
katise - kayise
Watekhala - Wayekhala
kuswtshenziswa - kusetshenziswa
sixobalula - sizobalula
lwalwendlzlekile - lwalwendlalekile
ayefana - ayegana
nfuye - nguye
nrzingxoxo - nezingxoxo
eaenkosi - ezenkosi
olwemza - olwenza
egqugquzeoa - egqugquzela
ebqabeni - enqabeni
koiwakhe - kokwakhe
eyiwiniso - eyiqiniso
nokubohgelwa - nokubongelwa
Uyabontwa - Uyabongwa
Lokuqhathanixa - Lokuqhathanisa
Ukythi - Ukuthi
akskhehle - akakhehle
izumpande - izimpande
ipjephabhuku - iphephabhuku
olubonakqla - olubonakala
ekhata - ekhaya
nenilingo - nemilingo
ogcona - ogcina
aqonca - aqonda
ongujcindezeli - ongumcindezeli
okungavexwanga - okungavezwanga
lalimkhonzule - lalimkhonzile
obqlulekile - obalulekile
efiaa - efisa
uaphumula - yaphumula
lzyikhomba - layikhomba
kisatikatikwa - kusatikatikwa
kokufunsa - kokufunda
ezinbi - ezimbi
kuyinlinga - kuyinkinga
Ykuthanda - Ukuthanda
zamelrkelela - zamelekelela
mjengesiboshwa - njengesiboshwa
ifabankamisa - ifanankamisa
lokucatshangwato - lokucatshangwayo
njengokjbalulekile - njengokubalulekile
yijuba - yikuba
kungabyekwa - kungabhekwa
mhsmbi - mhambi
usknga - usinga
nehkolo - nenkolo
nokuhlsziya - nokuhlaziya
lakjiwa - lakhiwa
umtheldla - umthelela
iuyanemba - kuyanemba
athumjwa - athunjwa
Ngeqanfa - Ngeqanda
mgalobo - ngalobo
kaKnayi - kaKhayi
intuthsane - intuthwane
zozine - zizine
waoibusa - walibusa
eziyixhumi - eziyishumi
zabqfana - zabafana
Ksafika - Kwafika
okifakwa - okufakwa
ayengamaxhumi - ayengamashumi
emzkmbeni - emzimbeni
ihlanbana - ihlangana
ygogo - ugogo
essdingida - esadingida
samqbinza - samabinza
likuthi - lokuthi
ukujola - ukuhola
ukugqamida - ukugqamisa
Wayeblna - Wayebona
ngokuthyla - ngokuthula
kugcime - kugcine
kugxina - kugcina
wezinganekwame - wezinganekwane
uzambane - izambane
sikhumgule - sikhumbule
ilanfa - ilanga
nkengombulali - njengombulali
abysa - abusa
uiuqhubeka - ukuqhubeka
aczbange - acabange
enxela - enzela
ezingahlukahiseki - ezingahlukaniseki
eBabsnango - eBabanango
ehkulumo - enkulumo
ikufcine - ikugcine
iaigodi - isigodi
batsgele - batshele
nonta - nonya
uManyisi - uManyosi
eabuye - wabuye
beghinqa - bebhinqa
ozimiseoe - ozimisele
semakyaya - semakhaya
ozqlweni - ozalweni
nabarana - nabafana
Ngexwe - Ngezwe
zibajbe - zibambe
nfobuqhawe - ngobuqhawe
ndpda - ndoda
uDingsne - uDingane
kwiaayensi - kwisayensi
Influ - Indlu
qziyele - aziyele
zigamelo - zigameko
Yayiphelrzelwa - Yayiphelezelwa
uCeoe - uCele
egxkle - egxile
sekunabanru - sekunabantu
spmnotho - somnotho
Ssimazi - Asimazi
yocwaninfo - yocwaningo
ezazibqame - ezazigqame
yaseNdobdakusuka - yaseNdondakusuka
ngaxinye - ngasinye
ngonhwaqa - ngongwaqa
okjyiwo - okuyiwo
iguaa - iguqa
yokunfafundi - yokungafundi
egakwa - efakwa
kwezimcwadi - kwezincwadi
abazonikela - abazinikela
zesihlayla - zesihlahla
lokuhlonisnwa - lokuhlonishwa
okuranayo - okufanayo
asetjandelwe - asethandelwe
zngafunzi - angafunzi
kudwaningwe - kucwaningwe
nokibaluleka - nokubaluleka
besiqa - besiwa
izonkunzi - izinkunzi
ubutwala - ubugwala
kqafika - kwafika
wenganela - wengamela
haleli - yaleli
olwandke - olwandle
enkondlwemi - enkondlweni
isigcwsgcwa - isigcwagcwa
ekabye - ekanye
izintana - izintaba
kubohgwa - kubongwa
unhume - umhume
kumgabulawa - kungabulawa
sesibephephandaba - sesinephephandaba
wkunikezeni - ekunikezeni
gesizonda - besizonda
ukwwnzelela - ukwenzelela
umyhombo - umthombo
ngrzenzo - ngezenzo
oziglaziyela - ozihlaziyela
kuhgani - kungani
embaka - emnaka
asakhoyhama - asakhothama
okujle - okuhle
wayejuveza - wayekuveza
amakyosikazi - amakhosikazi
Waxeyithatha - Waseyithatha
sado - saso
skubhala - akubhala
Ekuxebenziseni - Ekusebenziseni
ezqnzeka - ezanzeka
bapyumelela - baphumelela
Wabute - Wabuye
nbisho - ngisho
Wanuya - Wabuya
issyensi - isayensi
wayensuneu - wayensundu
osomlabdo - osomlando
yizihkulungwane - yizinkulungwane
njengpwakwenu - njengowakwenu
iglaya - ihlaya
okungukutni - okungukuthi
wahlela - Wahlela
AmaBhinu - AmaBhunu
wakhwwliswa - wakhweliswa
wamikezwa - wanikezwa
Kngwe - Ingwe
nfenkunzi - ngenkunzi
owzze - owaze
bajwazi - bakwazi
iwizwa - isizwa
isizowala - isizoqala
ssize - asize
aazakhelene - zazakhelene
ihlaseka - ihlasela
yinlinga - yinkinga
dzibonela - ezibonela
wokweyhulwa - wokwethulwa
yatyumba - yathumba
komlamdo - komlando
iaipho - izipho
sezibonto - sezibongo
lwamaknosazana - lwamakhosazana
Kungakihle - Kungakuhle
encwqdini - encwadini
kuyazowa - kuyaziwa
smbuza - ambuza
nazibto - nazinto
okqaphetha - okwaphetha
wayekucacixa - wayekucacisa
nqyekuzwa - nayekuzwa
solomon - Solomon
akaiaze - akakaze
kwagxina - kwagcina
yekhilikuthi - yekhilikithi
kaKhelhe - kaKhekhe
wayhi - wathi
olusihooko - olusihloko
uzuhgu - uzungu
websndla - webandla
ipjethini - iphethini
kungasetshenzkswa - kungasetshenziswa
okwaqharha - okwaqhatha
watehlukumeza - wayehlukumeza
nualo - njalo
ngokuthqthwa - ngokuthathwa
ixenzo - isenzo
neskkhathi - nesikhathi
eziqhuvekayo - eziqhubekayo
yimpahde - yimpande
agabhale - ababhale
ngqbacwaningi - ngabacwaningi
mbyalo - mbhalo
kusesahoukweni - kusesahlukweni
Ngokokwazi - Ngokolwazi
kutge - kuthe
ibuieke - ibukeke
ybuzwe - ubuzwe
wyakuthola - eyakuthola
nabeka - babeka
wabaleia - wabaleka
okucala - okudala
elkngontanga - elingontanga
vanda - banda
ukubuwa - ukubusa
yzphuma - yaphuma
wayeseneminyzka - wayeseneminyaka
mokushona - nokushona
ughunywe - uthunywe
ngabqholi - ngabaholi
ezisezibgeni - ezisezingeni
yeNkpsi - yeNkosi
okwasixa - okwasiza
abanbandi - abangandi
yakujhuza - yakukhuza
kjbhaliwe - kubhaliwe
awiveli - asiveli
ngesilo - ngeSilo
ukuphindea - ukuphindwa
inionyana - inkonyana
jkubulawa - ukubulawa
eligqamike - eligqamile
nabananye - nabamanye
ebinga - eninga
ayesekhukhyla - ayesekhukhula
ngqmadodana - ngamadodana
ezokwenxa - ezokwenza
owayeghandwa - owayethandwa
bekujuhlaziywa - bekukuhlaziywa
amalejbe - amalembe
olujulkle - olujulile
sibihelwe - sibiyelwe
uSolwaai - uSolwazi
kudslwa - kudalwa
avathi - abathi
ngokwehlujaniswa - ngokwehlukaniswa
zibiawe - zibizwe
zubizwa - zibizwa
sikhuhdla - sikhundla
ayeaobabuza - ayezobabuza
yaahatha - yaqhatha
luzwakqle - luzwakale
ezazingwke - ezazingeke
luzokwdlekelela - luzokwelekelela
sensinbi - sensimbi
ngomknonto - ngomkhonto
abzbulali - ababulali
inokeze - inikeze
ubuhoalu - ubuhlalu
umzukylu - umzukulu
oiumpilo - okumpilo
yomphaksthi - yomphakathi
ejoyeni - emoyeni
ukuzoxelwa - ukuxoxelwa
ngojuya - ngokuya
bengwnze - bengenze
zmadlozi - amadlozi
eyayibukqa - eyayibukwa
owqyedumile - owayedumile
ngwsigodlo - ngesigodlo
abssondele - abasondele
kwathiqa - kwathiwa
Nojunye - Nokunye
wSiyamu - eSiyamu
Phakqthi - Phakathi
izizukulwsne - izizukulwane
nbaphandle - ngaphandle
ngondlunkuku - ngondlunkulu
aiithi - akithi
yezigzmeko - yezigameko
Uzingane - Izingane
jwuphawu - uwuphawu
zeNkisi - zeNkosi
nguXhaka - nguShaka
nhenkambiso - ngenkambiso
Bssebefuna - Basebefuna
yazithpla - yazithola
exiNgisi - esiNgisi
olumeke - olumele
ohoaziywe - ohlaziywe
ujantshu - umantshu
ngokuvwza - ngokuveza
kuyiziswkelo - kuyizisekelo
sekuyamvacela - sekuyamcacela
wenzohdo - wenzondo
kuveoa - kuvela
wnkulu - enkulu
samszwi - samazwi
ngezigoei - ngezigodi
abazogambisa - abazohambisa
jThema - uThema
akzthandi - akathandi
kaMbtungwa - kaMntungwa
okuzophawylwa - okuzophawulwa
nemidlqlo - nemidlalo
ezknikezwa - ezinikezwa
luyibuka - liyibuka
navelaphi - bavelaphi
iyoewa - iyodwa
pwokuthi - owokuthi
okutgiwa - okuthiwa
zibutgwe - zibuthwe
zkzobika - zizobika
onesihouku - onesihluku
wszalelwa - wazalelwa
ongaphesjeya - ongaphesheya
Amadodakszi - Amadodakazi
Kuzosetshrnziswa - Kuzosetshenziswa
isifiie - isifike
zziqembulela - aziqembulela
ikjanda - ikhanda
srzikhishiwe - sezikhishiwe
okwzthatha - okwathatha
Ukunyskaza - Ukunyakaza
kwamukelea - kwamukelwa
ehayizobulawa - eyayizobulawa
yokungaphatni - yokungaphathi
unbudadewabo - ungudadewabo
kumumtu - kumuntu
babeyizihllbo - babeyizihlobo
yamvulala - yambulala
sieafake - siwafake
okumgasekho - okungasekho
bexinto - bezinto
lamsNazaretha - lamaNazaretha
ekuthythukiseni - ekuthuthukiseni
isekucwaningiwe - osekucwaningiwe
ziboma - zibona
lujlelwe - luhlelwe
nenhliko - nenhloko
beczsulwa - becasulwa
emizuzwibi - emizuzwini
kwakuyohlzselwa - kwakuyohlaselwa
exengene - esengene
sobzla - sobala
Lwakuthiwa - Kwakuthiwa
ehinkosi - eyinkosi
entaveni - entabeni
umkhankzso - umkhankaso
qemizi - wemizi
hgiyaye - ngiyaye
loiubhala - lokubhala
etsyela - etshela
Ngesinte - Ngesinye
isilinqobkle - isilinqobile
kusadonga - kusadinga
yizkkhulu - yizikhulu
kusliwa - kudliwa
ngenfcula - ngengcula
Yimbomgi - Yimbongi
tjey - they
umhlooa - umhlola
uqono - uqobo
ngesihlulu - ngesihluku
etgiwa - ethiwa
ykubhalwa - ukubhalwa
ababezi - abavezi
nzlawo - nalawo
owaywbekwe - owayebekwe
owsnqaba - owanqaba
nbqangi - ngqangi
bejbeka - bembeka
ugqizi - ugqozi
ayezosolalelisa - ayezosilalelisa
bizobaleka - nizobaleka
bukaZylu - bukaZulu
njengenelela - njengendlela
amqdala - amadala
lukivezile - lukuvezile
adunile - adumile
ibobga - ibonga
sebehlykana - sebehlukana
Aiyathola - Siyathola
euimele - eyimele
uduke - usuke
kwezonnotho - kwezomnotho
yzyohlangana - yayohlangana
yisyumi - yishumi
Ekinye - Elinye
uduku - usuku
Ncoda - Ndoda
isikewhi - isikeshi
mafama - magama
nokusona - nokusina
iylfika - iyofika
nude - bude
kwabaleia - kwabaleka
kungashowo - kungashiwo
Kuzibe - Kuzobe
atimele - ayimele
Kukesi - Kulesi
olutyile - oluthile
ezithendebi - ezithendeni
wayemendaba - wayenendaba
alhuluma - akhuluma
zimolimi - zinolimi
ntokuloba - ngokuloba
rqhuma - eqhuma
yebhlabathi - yenhlabathi
okwakuwolakala - okwakusolakala
kungexe - kungeze
jganelwani - uganelwani
aphumrlela - aphumelela
isetshebziswe - isetshenziswe
eqhathanisqa - eqhathaniswa
babexhazelwa - babechazelwa
sangena - wangena
owaxebukhosini - owasebukhosini
nmengesicelo - njengesicelo
wwzinto - wezinto
lwaluvdla - lwaluvela
Wqthi - Wathi
sifunfa - sifunda
ekuzalwemi - ekuzalweni
UMasweziwela - UMaswezisela
evehts - events
sasiyithamda - sasiyithanda
umphefumuoo - umphefumulo
skkhonjwa - sikhonjwa
zishicilelea - zishicilelwa
zishkcilelwe - zishicilelwe
Isizatgu - Isizathu
akuqddwe - akuqedwe
bokwenziwa - nokwenziwa
savuka - wavuka
limayelana - lumayelana
samcrla - samcela
sakwaNgcobo - wakwaNgcobo
ingqmukelwa - ingamukelwa
oselubhaliwe - osekubhaliwe
ijensli - ijenali
ukjcaciza - ukucaciza
muxi - muzi
okhukulekile - okhululekile
siuihloniphe - siyihloniphe
kuqhathankswe - kuqhathaniswe
mabcane - mancane
sesguminambili - seshuminambili
oowalungatholakala - olwalungatholakala
uylale - uhlale
ukukhuthzza - ukukhuthaza
Yayksinela - Yayisinela
ukjvuthwa - ukuvuthwa
qngabi - angabi
jThukela - uThukela
iNgobamakyosi - iNgobamakhosi
kuknomba - kukhomba
ngesago - ngesaho
enyanteni - enyangeni
wqyeselusa - wayeselusa
lfundisa - ofundisa
yiphitha - yiphutha
xonke - zonke
owrqa - oweqa
knyama - inyama
buhgabibikho - bungabibikho
ezongena - ezingena
hgesakhiwo - ngesakhiwo
olusemthethwebi - olusemthethweni
odinga - idinga
hlogo - hlobo
ibizse - ibizwe
ewondela - esondela
Izindokimba - Izindikimba
mobubi - nobubi
agayincomayo - abayincomayo
ayihlqlanga - ayihlalanga
qngalingi - angalingi
sebwtshengiswa - sebetshengiswa
zemiguzo - zemibuzo
Wasjo - Washo
yebutjo - yebutho
skvela - sivela
lwehlukebe - lwehlukene
namhlanke - namhlanje
kuvangelwa - kubangelwa
amaXhlsa - amaXhosa
nokunczne - nokuncane
wsyekhuluma - wayekhuluma
uthooe - uthole
iminyala - iminyaka
lwamaNgisi - kwamaNgisi
ezithkntene - ezithintene
kysenjalo - kusenjalo
ufezwe - uvezwe
kishona - lishona
yingesikhqthi - yingesikhathi
kwabafuha - kwabafuna
namakhqsi - namakhasi
uMqlandela - uMalandela
ngaleoo - ngalelo
ezkne - ezine
ezenzwwni - ezenzweni
yesithunai - yesithunzi
kuxoke - kuzoke
Qmagama - Amagama
otholaksle - otholakale
nojubulawa - nokubulawa
kucqshunwe - kucashunwe
luhzmbe - luhambe
Abasknda - Abasinda
oikaKhokho - likaKhokho
sesisniyagalombili - sesishiyagalombili
kulwyo - kuleyo
ezizova - ezizoba
Umnuso - Umbuso
ikalhulukazi - ikakhulukazi
esjiya - eshiya
nokubanokeza - nokubanikeza
syikwazi - ayikwazi
okuzotni - okuzothi
obekuqhathanoswa - obekuqhathaniswa
angsyidumisi - angayidumisi
nrnkuthazo - nenkuthazo
yeglisele - yehlisele
nqyekubhala - nayekubhala
ekisindayo - elisindayo
ixinhlobo - izinhlobo
sojubhala - sokubhala
wazana - wazama
nokudiseka - nokudideka
nobunle - nobuhle
ngobunyandlahyandla - ngobunyandlanyandla
sfike - afike
ukuphindaphincwa - ukuphindaphindwa
ekivezeni - ekuvezeni
kjkaNdlela - kukaNdlela
ngpkuphelelwa - ngokuphelelwa
kushuwo - kushiwo
ishomile - ishonile
Fughi - Futhi
kwakunganteni - kwakungangeni
zemkthi - zemithi
izikwenza - izokwenza
owendlalifa - lwendlalifa
ngaseBkandla - ngaseNkandla
Oiubalulekile - Okubalulekile
unhaka - unyaka
lemvongi - lembongi
ekukhkqizeni - ekukhiqizeni
neknono - nekhono
esekhuluna - esekhuluma
aknule - akhule