babeqgokise - babegqokise
wayesebezna - wayesebenza
yokuhkulunywayo - yokukhulunywayo
izizahtu - izizathu
abasesthenziswe - abasetshenziswe
zawkaZulu - zakwaZulu
suebuyela - usebuyela
ayyiqinisekisa - yayiqinisekisa
yivmelaphi - yimvelaphi
esalihbuqa - esalibhuqa
aWmema - Wamema
yayilugnile - yayilungile
eselhubuka - esehlubuka
abezohtakatha - abezothakatha
yadniswe - yandiswe
alehte - alethe
ayqoma - yaqoma
azzivele - zazivele
wahkulelwa - wakhulelwa
oykusabalalisa - yokusabalalisa
owayegnaqondakali - owayengaqondakali
nekNosi - neNkosi
babehso - babesho
bebognela - bebongela
ayqoqa - yaqoqa
laisibekela - alisibekela
seilaziyo - esilaziyo
lagnonyaka - langonyaka
gNifisa - Ngifisa
aWyebuye - Wayebuye
wKabacacela - Kwabacacela
yahpatheka - yaphatheka
yahtumela - yathumela
yiiveza - iyiveza
yayisidiwde - yayisididwe
Babemagnaliswa - Babemangaliswa
okugnamanoveli - okungamanoveli
ezazisthengisa - ezazitshengisa
osiqgi - osigqi
uluhtola - uluthola
aWba - Waba
siwzakala - sizwakala
bahsicilele - bashicilele
ezewle - ezelwe
aLba - Laba
dNlunkulu - Ndlunkulu
kabuhsa - kabusha
yisilhoko - yisihloko
hputha - phutha
isiqohpamazwi - isiqophamazwi
gnimfunyene - ngimfunyene
ezivuwka - ezivukwa
Sekuhqathanisiwe - Sekuqhathanisiwe
gnomsebenzi - ngomsebenzi
abfe - bafe
Kuzohbekwa - Kuzobhekwa
uhkona - ukhona
wkakhona - kwakhona
lalihti - lalithi
Evma - Emva
anmikeza - amnikeza
luyidnlela - luyindlela
ibuyiwse - ibuyiswe
anbalalele - nabalalele
yopmhefumulo - yomphefumulo
zihbalwe - zibhalwe
aymabela - yamabela
gnokugwegwa - ngokugwegwa
wkakukhombisa - kwakukhombisa
asbeka - sabeka
kabMonde - kaMbonde
Amawzi - Amazwi
uyihcaza - uyichaza
ukugnawethembi - ukungawethembi
emiqodnweni - emiqondweni
ezolhonipha - ezohlonipha
okufuwna - okufunwa
utmhole - umthole
siafika - isafika
iknambo - inkambo
ukubogna - ukubonga
iyelhuka - iyehluka
biuyelela - ibuyelela
wlaziwa - lwaziwa
kugnakhulunywa - kungakhulunywa
wahbalwa - wabhalwa
siisu - isisu
olkubalekela - lokubalekela
abawlela - abalwela
okuhkulunywa - okukhulunywa
isqubula - siqubula
Sekuzohbekwa - Sekuzobhekwa
ubMhekenya - uMbhekenya
siibona - isibona
idNlovukazi - iNdlovukazi
nednodana - nendodana
yolmando - yomlando
ezibmongini - ezimbongini
uzohabma - uzohamba
ukulhala - ukuhlala
wesilhanu - wesihlanu
luxgile - lugxile
yayinowlazi - yayinolwazi
siimo - isimo
gneyaseThalaneni - ngeyaseThalaneni
abya - baya
siilo - isilo
elkoloda - ekloloda
asilhanganise - asihlanganise
kusegnenzeka - kusengenzeka
ignane - ingane
anamahtele - anamathele
izihtunywa - izithunywa
ezisebeznile - ezisebenzile
aWqoma - Waqoma
wayognenisa - wayongenisa
abanowkazi - abanokwazi
naseNignizimu - naseNingizimu
ohkulu - okhulu
amnoveli - manoveli
ubuhkulu - ubukhulu
wkelakithi - kwelakithi
gnokuvakashela - ngokuvakashela
buude - ubude
okuhtandwayo - okuthandwayo
Owkathi - Okwathi
biemukele - ibemukele
elibuhkali - elibukhali
azilhela - azihlela
zazignabhaliwe - zazingabhaliwe
siqodne - siqonde
abawkaNgongoma - abakwaNgongoma
iYleso - Yileso
leinamasiko - elinamasiko
namahkosi - namakhosi
keuqoqeni - ekuqoqeni
zaibeke - azibeke
wKakukhona - Kwakukhona
zeiyaye - eziyaye
uwkethwasa - ukwethwasa
obbane - bobane
ezixgila - ezigxila
egnasusela - engasusela
yasthelwa - yatshelwa
abzosizakala - bazosizakala
wkabulawa - kwabulawa
abanigni - abaningi
emilhangwaneni - emihlangwaneni
bayalignana - bayalingana
bUuqiniso - Ubuqiniso
ukdala - kudala
egnavela - engavela
ekuhbaleni - ekubhaleni
wkabulala - kwabulala
kofmula - komfula
gnenkulu - ngenkulu
Wawusilhoko - Wawusihloko
okkuqala - kokuqala
kuyavewza - kuyavezwa
Yayigawne - Yayiganwe
obognela - obongela
uMatnantashiya - uMantantashiya
Babuhpuzwa - Babuphuzwa
kasiliwza - kasilizwa
izyigama - ziyigama
kOokuqala - Okokuqala
ecahsuniwe - ecashuniwe
woamamukela - owamamukela
wlenziwa - lwenziwa
eyza - yeza
wlenziwe - lwenziwe
suifice - usifice
cihse - cishe
yeaziwa - eyaziwa
izihtombemagama - izithombemagama
ilveza - liveza
awuhbala - awubhala
nocmabango - nomcabango
okucginwe - okugcinwe
ognuyisekazi - onguyisekazi
emahkulwini - emakhulwini
ayesiwza - ayesizwa
Kuyezneka - Kuyenzeka
maxnusa - manxusa
awselisa - waselisa
selulhela - seluhlela
yilihpi - yiliphi
zihka - zikha
eyayidigna - eyayidinga
kouyiyonayona - okuyiyonayona
bayohkonza - bayokhonza
gnibona - ngibona
lasekNandla - laseNkandla
gNemva - Ngemva
lihbekwa - libhekwa
gnokwenzeka - ngokwenzeka
abiwze - abizwe
ezezna - ezenza
isiyowla - isiyolwa
woawukade - owawukade
eyayilda - eyayidla
buuciko - ubuciko
sihti - sithi
kukaMawgegwana - kukaMagwegwana
izignxenye - izingxenye
ababalewla - ababalelwa
zahti - zathi
jnengengxenye - njengengxenye
ikuwza - ikuzwa
wkakuzobulawa - kwakuzobulawa
gNokuqhubeka - Ngokuqhubeka
likadNunankulu - likaNdunankulu
izidnawo - izindawo
ekNosini - eNkosini
baesifazane - abesifazane
esebuhtweni - esebuthweni
yayolhola - yayohlola
ehtunywe - ethunywe
ukubmiza - ukumbiza
iknondlo - inkondlo
nagnuSolwazi - nanguSolwazi
nowkakhelene - nokwakhelene
zehtula - zethula
wkeNkosi - kweNkosi
ebahsiya - ebashiya
ehqathaniswayo - eqhathaniswayo
gNaphakathi - Ngaphakathi
gnezikhathi - ngezikhathi
isusewla - isuselwa
utNombazana - uNtombazana
yahsaqeka - yashaqeka
bazihsiya - bazishiya
Isilhoko - Isihloko
alugnene - alungene
wkabantu - kwabantu
gnokukhalipha - ngokukhalipha
abyofika - bayofika
isbuke - sibuke
uKyacaca - Kuyacaca
akuwcaningayo - akucwaningayo
yayelhisa - yayehlisa
eyayignenzelwangwa - eyayingenzelwangwa
belibelehpi - belibelephi
kuyawehtula - kuyawethula
wkakuthe - kwakuthe
ebmi - embi
izcace - zicace
owawahkiwe - owawakhiwe
sokuhxumana - sokuxhumana
izidnaba - izindaba
wayegnafuni - wayengafuni
iskaZulu - sikaZulu
behkokhoba - bekhokhoba
zignenakho - zingenakho
ayihbala - ayibhala
agnaphambili - angaphambili
obkuqala - bokuqala
uyignxenye - uyingxenye
abkaSihayo - bakaSihayo
umuqga - umugqa
zmimba - mzimba
nesiwne - nesinwe
eyayihkothamele - eyayikhothamele
ensoka - nesoka
nmyana - mnyana
okuyiynoka - okuyinyoka
isbuya - sibuya
okuhkumbula - okukhumbula
awbulawa - wabulawa
sahkolelwa - sakholelwa
alkubo - lakubo
ebeluhkuni - ebelukhuni
gnokuhlanganisa - ngokuhlanganisa
zahkipha - zakhipha
mIigomo - Imigomo
Bagnabantu - Bangabantu
doumile - odumile
wehtu - wethu
ukulhela - ukuhlela
vaeze - aveze
gnamakhosazana - ngamakhosazana
izidnlubu - izindlubu
awbo - wabo
negnqikithi - nengqikithi
kunamahkosi - kunamakhosi
abanowlazi - abanolwazi
ognenanhlonipho - ongenanhlonipho
uyobabma - uyobamba
yayihbekwa - yayibhekwa
selihkona - selikhona
ezazelhulwe - ezazehlulwe
ulmando - umlando
ihpathelene - iphathelene
balulhela - baluhlela
eyayihpila - eyayiphila
ahbalwa - abhalwa
kulodnolozwe - kulondolozwe
ukufilha - ukufihla
wayeqgugquzela - wayegqugquzela
iknululeko - inkululeko
yowda - yodwa
yisiwda - yisidwa
awke - wake
wkezingamashumi - kwezingamashumi
kouvumela - okuvumela
ukuhkiqiza - ukukhiqiza
alka - laka
nezidnlela - nezindlela
ezibognweni - ezibongweni
buusuku - ubusuku
abvuka - bavuka
gNiyakuwubuza - Ngiyakuwubuza
iskulo - sikulo
awlo - walo
Agnikhulumanga - Angikhulumanga
Zibadnlela - Zibandlela
buuyela - ubuyela
bafudna - bafunda
Sihso - Sisho
nezidnleko - nezindleko
ukyabonakala - kuyabonakala
buuyena - ubuyena
elinmyama - elimnyama
siicoco - isicoco
kaazani - akazani
wkehlambo - kwehlambo
esiwsini - esiswini
owkesibili - okwesibili
Ehpawula - Ephawula
Signazitholela - Singazitholela
ukuhkombisile - ukukhombisile
edne - ende
likmhuza - limkhuza
jnengazo - njengazo
eziladnelayo - ezilandelayo
hkonsathi - khonsathi
kajne - kanje
abasnundu - abansundu
abahpela - abaphela
akasthalwe - akatshalwe
ukulhobana - ukuhlobana
woayeba - owayeba
alwo - lawo
abagnaveli - abangaveli
kouyikomidi - okuyikomidi
wahkiwe - wakhiwe
isiyokuwla - isiyokulwa
nezidnlebe - nezindlebe
seeya - eseya
yayiwkazi - yayikwazi
iwza - izwa
ignxenye - ingxenye
yaaziwa - ayaziwa
awmabele - wamabele
siiZulu - isiZulu
owkakubonwa - okwakubonwa
UMaladnela - UMalandela
gNiyawabona - Ngiyawabona
quala - uqala
uhSaka - uShaka
iwzi - izwi
zinamabizna - zinamabinza
wkesikhulu - kwesikhulu
yuefana - uyefana
kosolmando - kosomlando
gnempela - ngempela
agncwatshelwa - angcwatshelwa
gNokwezibongo - Ngokwezibongo
sekugnezwakali - sekungezwakali
Lunigni - Luningi
uyisihqwaga - uyisiqhwaga
bednlu - bendlu
samabadnla - samabandla
ibmuza - imbuza
abnikela - banikela
sonmtanakhe - somntanakhe
bazokulugnela - bazokulungela
izcacise - zicacise
ayefaniwsa - ayefaniswa
Okuhso - Okusho
seebulewe - esebulewe
onlaka - nolaka
ziama - izama
yAiqedile - Ayiqedile
seusela - esusela
idnuku - induku
esebeznisa - esebenzisa
gnoMnyayiza - ngoMnyayiza
begnakwamukeli - bengakwamukeli
agnamdidi - angamdidi
seyisodnela - seyisondela
eSiwleni - eSilweni
gnosekubhaliwe - ngosekubhaliwe
eLsi - Lesi
ahqubeke - aqhubeke
ukuhkulula - ukukhulula
wkakuwumuzi - kwakuwumuzi
ezne - enze
kuhBuzana - kuBhuzana
sIibonelo - Isibonelo
olkuveza - lokuveza
ednlunkulu - endlunkulu
ebse - bese
wahkonza - wakhonza
buuye - ubuye
Banigni - Baningi
abnikeze - banikeze
kuuvumela - ukuvumela
gNidi - Ngidi
yabehqatha - yabeqhatha
baafazi - abafazi
ukuhkuluma - ukukhuluma
ebza - beza
wobmuso - wombuso
ebya - beya
Bayakufilha - Bayakufihla
ehbekise - ebhekise
esehpotha - esephotha
okugnuyena - okunguyena
eyelhukile - eyehlukile
abacgina - abagcina
balihbekisa - balibhekisa
Zihbebhu - Zibhebhu
kaMasnumpa - kaMansumpa
ozognena - ozongena
tnombi - ntombi
oylimi - yolimi
wlavala - lwavala
wayeyidnodakazi - wayeyindodakazi
ukuvikewla - ukuvikelwa
iybo - yibo
wkakulele - kwakulele
awveza - waveza
ufmana - umfana
bialulekile - ibalulekile
izomeznela - izomenzela
uhPunga - uPhunga
Kunigni - Kuningi
wkabendlu - kwabendlu
inehnlanhla - inenhlanhla
wobmelebele - wombelebele
ifulahtela - ifulathela
baafana - abafana
zihnlanu - zinhlanu
okugnasuselwa - okungasuselwa
Sanamulha - Sanamuhla
imeyniwe - imenyiwe
wlalelo - lwalelo
iMne - Mine
ihkona - ikhona
ihkono - ikhono
Wayesehti - Wayesethi
ziqukehte - ziqukethe
amahkizane - amakhizane
kaubeka - akubeka
inna - nina
yayiqoynwe - yayiqonywe
iyle - yile
siimide - isimide
izigilakmhuba - izigilamkhuba
obabuhtandwa - obabuthandwa
ukuvibma - ukuvimba
ozawle - ozalwe
kokugulduzwa - kokugudluzwa
ezidniza - ezindiza
amalhokohloko - amahlokohloko
assiyibiza - sasiyibiza
wkemvume - kwemvume
iylolu - yilolu
Esiwzeni - Esizweni
gnoyise - ngoyise
lokubuyisewla - lokubuyiselwa
wkamantombazane - kwamantombazane
omuhsa - omusha
ehqamuka - eqhamuka
essibulewe - sesibulewe
ukyinika - kuyinika
jnengolubizayo - njengolubizayo
kugnaziwa - kungaziwa
loufanele - olufanele
gnasesandleni - ngasesandleni
wiusizo - iwusizo
awyematasatasa - wayematasatasa
weziknomo - wezinkomo
nagneso - nangeso
abbadubula - babadubula
yiaye - iyaye
iyze - yize
esecgoba - esegcoba
ihabme - ihambe
Ugnwaqa - Ungwaqa
uNomatnshali - uNomantshali
wayehbeka - wayebheka
wkakunenkinga - kwakunenkinga
behtuthumela - bethuthumela
okuxgilwe - okugxilwe
beusuku - ebusuku
yasihpaka - yasiphaka
eknathini - enkathini
namatnombazane - namantombazane
woawubonakala - owawubonakala
amahkona - amakhona
utmhokozo - umthokozo
baabezinikela - ababezinikela
yatmhola - yamthola
fiilosofi - ifilosofi
okuyilahpo - okuyilapho
ezinolmando - ezinomlando
soeluke - oseluke
koynaka - konyaka
Wayegnumuntu - Wayengumuntu
HUulumeni - UHulumeni
wayegnumeluleki - wayengumeluleki
Seznangakhona - Senzangakhona
ifudniswe - ifundiswe
jNengesifiso - Njengesifiso
owawunoymalezo - owawunomyalezo
niani - inani
eyezna - eyenza
kuubeka - ukubeka
abagnamakhulu - abangamakhulu
nednawo - nendawo
labuyekewza - labuyekezwa
ciala - icala
ihbekene - ibhekene
abawcaningi - abacwaningi
tnonga - ntonga
gnezintombi - ngezintombi
jnengalaba - njengalaba
kaafike - akafike
nokuhabma - nokuhamba
wkezinkulungwane - kwezinkulungwane
koubaluleka - okubaluleka
ezisusewle - ezisuselwe
egNonyameni - eNgonyameni
idnodana - indodana
yayihkolelwa - yayikholelwa
akZulu - kaZulu
iyozignela - iyozingela
sotmhetho - somthetho
esiqgikini - esigqikini
agnalubeki - angalubeki
gnokulwa - ngokulwa
lemihbalo - lemibhalo
gnobunjalo - ngobunjalo
ayisihtupha - ayisithupha
ababegnalwazi - ababengalwazi
gnenkomo - ngenkomo
lesiwze - lesizwe
sazehtula - sazethula
alehtiwa - alethiwa
necnazelo - nencazelo
ukyibeka - kuyibeka
beuza - ebuza
siiqedile - isiqedile
ozkuqala - zokuqala
emihkulu - emikhulu
ayefudniswa - ayefundiswa
ezazezneka - ezazenzeka
sioka - isoka
abanikewze - abanikezwe
zazelhukanisiwe - zazehlukanisiwe
uKbonakala - Kubonakala
ayyiyobona - yayiyobona
yahtola - yathola
bialeke - ibaleke
Epmini - Empini
maadodakazi - amadodakazi
nodmlunkulu - nomdlunkulu
gnekhonsathi - ngekhonsathi
nehpupho - nephupho
odmala - omdala
Weqnabela - Wenqabela
esesiwehtulelwe - esesiwethulelwe
gnabaphansi - ngabaphansi
isilde - isidle
wababma - wabamba
okkuba - kokuba
gnentungwana - ngentungwana
kubatnwana - kubantwana
uhsiswa - ushiswa
gnomfula - ngomfula
gneyesikhumba - ngeyesikhumba
kuudumisa - ukudumisa
nonmdeni - nomndeni
kuCesthwayo - kuCetshwayo
efudna - efunda
wayelhose - wayehlose
ehpindelela - ephindelela
zicnwadi - zincwadi
kuunika - ukunika
behkona - bekhona
ababezna - ababenza
zazisthengisa - zazitshengisa
awyisiza - wayisiza
koubonakala - okubonakala
okne - onke
kayahkele - kayakhele
siifuna - isifuna
ihbeka - ibheka
usenmcane - usemncane
imiqga - imigqa
elhambeni - ehlambeni
zikuwze - zikuzwe
bualula - ubalula
gnakuzo - ngakuzo
onnina - nonina
Kugneze - Kungeze
owkakuwumuzi - okwakuwumuzi
kuNomagnci - kuNomangci
zeicacile - ezicacile
abmalwa - ambalwa
luhqutshwa - luqhutshwa
abbulala - babulala
bialekela - ibalekela
kuulawula - ukulawula
amahkulu - amakhulu
woamela - owamela
ukusthaka - ukutshaka
yanmikeza - yamnikeza
ello - lelo
beulele - ebulele
onvalo - novalo
esihbaliwe - esibhaliwe
abbulali - babulali
isihtaphuza - isithaphuza
ihnlosongqangi - inhlosongqangi
Signabuye - Singabuye
gnokuqhubekisa - ngokuqhubekisa
luhpose - luphose
gnemvelaphi - ngemvelaphi
ukyavela - kuyavela
esizukuwlaneni - esizukulwaneni
ebognelwayo - ebongelwayo
nezisnizwa - nezinsizwa
ewna - wena
kasidigni - kasidingi
notnanga - nontanga
sokuvewza - sokuvezwa
elhangene - ehlangene
yeobazisa - eyobazisa
eyayiseqnabeni - eyayisenqabeni
elso - leso
ukuhkulisa - ukukhulisa
beulewe - ebulewe
luhtintwa - luthintwa
kubme - kumbe
lahabma - lahamba
ayvumela - yavumela
dnlela - ndlela
ukuhbekana - ukubhekana
izilokohto - izilokotho
onMtwana - oMntwana
asebeznisana - asebenzisana
keubeni - ekubeni
gnokubuya - ngokubuya
elzo - lezo
ankuba - nakuba
Iziknondlo - Izinkondlo
elyo - leyo
basmhaya - bamshaya
ababesepmilweni - ababesempilweni
Amahkosazana - Amakhosazana
lizolhala - lizohlala
zezneka - zenzeka
ukqale - kuqale
sokuhtathwa - sokuthathwa
isfile - sifile
wahpambana - waphambana
Azizinigni - Aziziningi
eyibmongi - eyimbongi
imiqodno - imiqondo
awnikeza - wanikeza
eselhuliwe - esehluliwe
onbuqiniso - nobuqiniso
onyisekazi - noyisekazi
aybiza - yabiza
esahkiweni - esakhiweni
bealuleke - ebaluleke
ayvela - yavela
gnokukaKhumalo - ngokukaKhumalo
hTambekeka - Thambekeka
baagana - abagana
wavalewla - wavalelwa
ulbagasela - lubagasela
kuwzakale - kuzwakale
ehkanda - ekhanda
ukuzignela - ukuzingela
asebeznise - asebenzise
yayisilihpimise - yayisiliphimise
okugnaguquka - okungaguquka
okuhbalwa - okubhalwa
wayesehpethe - wayesephethe
gnomama - ngomama
wkezine - kwezine
kuuxabana - ukuxabana
abwufica - bawufica
yayibognwa - yayibongwa
siwze - sizwe
Ugnumuntu - Ungumuntu
 - lwe
ayehtunyiwe - ayethunyiwe
mUuzi - Umuzi
kunebmizo - kunembizo
ehpakathi - ephakathi
hnlobo - nhlobo
seebaqedile - esebaqedile
onkubabona - nokubabona
Wahabma - Wahamba
wkakuliwa - kwakuliwa
gnokubuka - ngokubuka
ignasazi - ingasazi
kNosinkulu - Nkosinkulu
wkentaba - kwentaba
ihtathe - ithathe
owayelignana - owayelingana
yeofuna - eyofuna
yemihtetho - yemithetho
Ulmobi - Umlobi
gnendlela - ngendlela
wahka - wakha
edNliwayini - eNdliwayini
bamahBunu - bamaBhunu
Magowlana - Magolwana
eyayinoyna - eyayinonya
signalwa - singalwa
ewkethuleni - ekwethuleni
ayeqajnwa - ayeqanjwa
gnamehlo - ngamehlo
gnokubusa - ngokubusa
izobowna - izobonwa
sekunocgobho - sekunogcobho
licahsunwe - licashunwe
ekuqgugquzeleni - ekugqugquzeleni
awwuba - wawuba
zeaziwa - ezaziwa
aqukehte - aqukethe
ebsifazane - besifazane
esawkazi - esakwazi
sokuhsicilelwa - sokushicilelwa
woayebona - owayebona
elicgwalisa - eligcwalisa
Babewla - Babelwa
yayignumhlobo - yayingumhlobo
ayehtunywe - ayethunywe
nasekuhtuthukisweni - nasekuthuthukisweni
gnalokho - ngalokho
isebulhungwini - isebuhlungwini
nezaseNignizimu - nezaseNingizimu
eqabma - eqamba
enesilhonti - enesihlonti
mogno - mongo
seibi - esibi
yelhulekile - yehlulekile
ehbekene - ebhekene
yagnena - yangena
abmambe - ambambe
sekulhaziywa - sekuhlaziywa
Bezna - Benza
ayyiveza - yayiveza
gnokufunda - ngokufunda
kouyilawa - okuyilawa
gnomhluzi - ngomhluzi
kufakazewla - kufakazelwa
leuka - eluka
elhane - ehlane
kubewke - kubekwe
kasikmhaleli - kasimkhaleli
ukuhtuthukisa - ukuthuthukisa
ulhanya - uhlanya
babegnezukuyazi - babengezukuyazi
esmhweni - emshweni
ecmimbini - emcimbini
bagnakhula - bangakhula
abayihpazamisi - abayiphazamisi
gnomlayezo - ngomlayezo
ukumihta - ukumitha
begnazelele - bengazelele
zihte - zithe
awkuleyo - wakuleyo
sikuqodne - sikuqonde
zabaligniswa - zabalingiswa
akuhkohlakali - akukhohlakali
iysona - yisona
ubMuso - uMbuso
wayezolhala - wayezohlala
wKakungabantu - Kwakungabantu
ognazange - ongazange
yazawla - yazalwa
niele - inele
ihkohlwa - ikhohlwa
ehsayisanayo - eshayisanayo
asesthenziswayo - asetshenziswayo
efanekiwsa - efanekiswa
siyewza - siyezwa
neyne - nenye
yowlazi - yolwazi
wkasheshisa - kwasheshisa
eseladnela - eselandela
gnamangakanani - ngamangakanani
feeni - efeni
kulohku - kulokhu
gnehora - ngehora
seeqoka - eseqoka
ihkulula - ikhulula
leifunayo - elifunayo
yayignekho - yayingekho
aldondlobala - adlondlobala
wewza - wezwa
ziqajnwa - ziqanjwa
Isigoldo - Isigodlo
losolmando - losomlando
uMahpitha - uMaphitha
ayyiwabulele - yayiwabulele
azbulawa - zabulawa
ezazignabhekiwe - ezazingabhekiwe
feela - efela
azzinobunoveli - zazinobunoveli
sadugnuzela - sadunguzela
biabuze - ibabuze
ayixgilile - ayigxilile
konmtwana - komntwana
ewzakale - ezwakale
Usmimude - Umsimude
labatnu - labantu
esesodnela - esesondela
uzowkenza - uzokwenza
olkuholela - lokuholela
mahkosazana - makhosazana
ugnaze - ungaze
ceacisa - ecacisa
lokuqabma - lokuqamba
yayilheli - yayihleli
awmagama - wamagama
neynamazane - nenyamazane
bayowkesaba - bayokwesaba
banigni - baningi
uwkazi - ukwazi
sihtatha - sithatha
okuhcazwa - okuchazwa
esifuhsane - esifushane
noawo - onawo
wayolhala - wayohlala
nohko - nokho
seiZulu - esiZulu
awvelela - wavelela
yaefana - ayefana
sahtukuthela - sathukuthela
esihkathini - esikhathini
yieke - iyeke
owezne - owenze
kuvuynelwe - kuvunyelwe
ayewahkele - ayewakhele
zivmikele - zimvikele
keula - ekula
kacnane - kancane
gNaphambi - Ngaphambi
esiwze - esizwe
esiwza - esizwa
kukaJatnoni - kukaJantoni
woawela - owawela
iqodnene - iqondene
siibaleka - isibaleka
jnengezwe - njengezwe
esiZuwlini - esiZulwini
absibikela - basibikela
ognazalelwanga - ongazalelwanga
bayihtola - bayithola
biala - ibala
nepmi - nempi
yainabo - ayinabo
okuhpathelene - okuphathelene
evle - vele
ilsuke - lisuke
okuqgugquzela - okugqugquzela
lihkombise - likhombise
ehpilile - ephilile
behpinga - bephinga
emanigni - emaningi
gnokuzicindezela - ngokuzicindezela
bAafana - Abafana
ifmibinga - imfibinga
izihnlaka - izinhlaka
ewmali - wemali
labahmlophe - labamhlophe
qaokiwe - aqokiwe
isthela - itshela
yokulhabana - yokuhlabana
abaladneli - abalandeli
ayebasebeznisa - ayebasebenzisa
signakwenzi - singakwenzi
iqnubo - inqubo
owmabili - womabili
ukulhabana - ukuhlabana
sasibewke - sasibekwe
Isihumuhso - Isihumusho
gnezimpaphe - ngezimpaphe
yayilehtwe - yayilethwe
ehmlabeni - emhlabeni
abahkele - abakhele
Wasehabma - Wasehamba
kugnowakwenu - kungowakwenu
duaba - udaba
uknaleyo - kunaleyo
obuhsubile - obushubile
sihkuluma - sikhuluma
odnlaleke - ondlaleke
nesadnla - nesandla
ekububmeni - ekubumbeni
ubulewle - ubulelwe
kabMhengi - kaMbhengi
asthela - atshela
aluzukubabihko - aluzukubabikho
ugNotsha - uNgotsha
leigama - eligama
gnokweso - ngokweso
amduzane - maduzane
ilbe - libe
ibabma - ibamba
yabuhta - yabutha
eseyignxenye - eseyingxenye
gnokubhala - ngokubhala
UMagowlana - UMagolwana
wayezihkathaze - wayezikhathaze
elalihkumbula - elalikhumbula
izgigaba - zigigaba
Kuhtiwa - Kuthiwa
elihpezulu - eliphezulu
nohToludaba - noTholudaba
agnaphezulu - angaphezulu
allowo - lalowo
abaxohsiswa - abaxoshiswa
wakihti - wakithi
oykufa - yokufa
jnongo - njongo
agnabethi - angabethi
gnokukhothama - ngokukhothama
okugneyena - okungeyena
ognenayo - ongenayo
Izicnwadi - Izincwadi
asnoma - sanoma
uhkulume - ukhulume
uhkuluma - ukhuluma
kuuvuma - ukuvuma
ognangezintaba - ongangezintaba
Wasthwelwa - Watshwelwa
enesihtunzi - enesithunzi
eliladnelayo - elilandelayo
oyignozi - oyingozi
gnamabutho - ngamabutho
eNignizimu - eNingizimu
obuhtile - obuthile
UkDt - UDkt
ayahtanda - ayathanda
meidala - emidala
yaezobona - ayezobona
wlasekhaya - lwasekhaya
jnengendaba - njengendaba
ewketheni - ekwetheni
wkakungalindelwe - kwakungalindelwe
nohtando - nothando
awlolu - walolu
wokuhtakatha - wokuthakatha
ayelhabana - ayehlabana
ukliqiniso - kuliqiniso
etnangeni - entangeni
vuumelekile - uvumelekile
leibalulekile - elibalulekile
ablimela - balimela
zeaholela - ezaholela
bacnamele - bancamele
izohpindisela - izophindisela
onmcane - omncane
kugulduzwe - kugudluzwe
Wayegnenandaba - Wayengenandaba
lefmundo - lemfundo
ognafakazelwanga - ongafakazelwanga
lasnukuzonke - lansukuzonke
gNonyaka - Ngonyaka
ukubognela - ukubongela
amahbukwana - amabhukwana
moama - omama
gnamadolo - ngamadolo
wayahke - wayakhe
likaCesthwayo - likaCetshwayo
siisusa - isisusa
wkakufanele - kwakufanele
wkenza - kwenza
wkenye - kwenye
eyayinobmono - eyayinombono
bapmhakele - bamphakele
gnaxoxa - ngaxoxa
esicgwele - esigcwele
iyahabmisana - iyahambisana
owkabantu - okwabantu
uwkandisa - ukwandisa
ehpawula - ephawula
nagnamaphepha - nangamaphepha
ehpawule - ephawule
nesehsumi - neseshumi
azoyihcazela - azoyichazela
esihkombisa - esikhombisa
okuyidnlu - okuyindlu
gnukuba - ngukuba
ohtile - othile
bahtole - bathole
yiknondlo - yinkondlo
oluznima - olunzima
wKaxoxiswana - Kwaxoxiswana
owlaluqondwa - olwaluqondwa
umelaynaniswa - umelanyaniswa
oykucacisa - yokucacisa
wayenezahke - wayenezakhe
emalhathini - emahlathini
hPumanyova - Phumanyova
ihtuna - ithuna
zezniwa - zenziwa
yizibmongi - yizimbongi
sihcazwa - sichazwa
hoayayo - ohayayo
jnengombumbi - njengombumbi
wkamadlozi - kwamadlozi
uwlazi - ulwazi
ukubewka - ukubekwa
akuladnwe - akulandwe
ewlela - elwela
Elihabme - Elihambe
Amabuhto - Amabutho
icnike - incike
eymigudu - yemigudu
siibalekela - isibalekela
yefmundiso - yemfundiso
siziqnobile - sizinqobile
esihti - esithi
ukwona - kuwona
zeibalulekile - ezibalulekile
wkamabutho - kwamabutho
nezihnlelo - nezinhlelo
nokugnamukeleki - nokungamukeleki
zignekho - zingekho
olugnaphakathi - olungaphakathi
sesilhanu - sesihlanu
lahpelelwa - laphelelwa
egnazelele - engazelele
okucnomekayo - okuncomekayo
neknondlo - nenkondlo
yaesele - ayesele
ayihpakamise - ayiphakamise
abeLugnu - abeLungu
yabewka - yabekwa
wayeyisihkulu - wayeyisikhulu
yikuhpi - yikuphi
akhulumeni - kahulumeni
elawkaZulu - elakwaZulu
gnokusizwa - ngokusizwa
ulalheke - ulahleke
wawugneke - wawungeke
segnithumela - sengithumela
yowkenza - yokwenza
gnengxabano - ngengxabano
elakuwzayo - elakuzwayo
aPton - Paton
izihtokozise - izithokozise
olusesthenzisiwe - olusetshenzisiwe
UNozihbuku - UNozibhuku
ewzabo - wezabo
egnafanele - engafanele
aSse - Sase
wabaqnoba - wabanqoba
uKfanele - Kufanele
kubelugnu - kubelungu
eyayahke - eyayakhe
enokuhtula - enokuthula
siibonakala - isibonakala
Umagowlana - Umagolwana
wayihbala - wayibhala
abakmhumbulayo - abamkhumbulayo
ehkethekile - ekhethekile
ukkayise - kukayise
zignavezi - zingavezi
gnezimpi - ngezimpi
awabonagna - awabonanga
emidnenini - emindenini
saiqedele - asiqedele
juuba - ujuba
okuhqathaniswa - okuqhathaniswa
neqebmu - neqembu
zeaba - ezaba
wlemibuzo - lwemibuzo
ukmemeza - kumemeza
egnalele - engalele
izicnwadi - izincwadi
yokuhkulisa - yokukhulisa
ahka - akha
iscela - sicela
ebxoxisana - bexoxisana
annaso - nanaso
owkaphazamisa - okwaphazamisa
kOumele - Okumele
kouzoba - okuzoba
seyibekewle - seyibekelwe
siicela - isicela
owegnamele - owengamele
nekninga - nenkinga
ekuhtoleni - ekutholeni
ezidigna - ezidinga
nokugnefani - nokungefani
ezmini - emzini
eyzulu - yezulu
gnazozonke - ngazozonke
ezifudnile - ezifundile
uyakuhcaza - uyakuchaza
NUomagaga - UNomagaga
obbabili - bobabili
iknabi - inkabi
okuyiynuvesi - okuyinyuvesi
ehpoqelekile - ephoqelekile
Abayne - Abanye
lokuladnelana - lokulandelana
allibabazeka - lalibabazeka
abahkulelwe - abakhulelwe
koqmondo - komqondo
gnokusonga - ngokusonga
zeikoleni - ezikoleni
ekuhsicilelweni - ekushicilelweni
kugnakuhle - kungakuhle
ebiwza - ebizwa
abayihsumi - abayishumi
yaenabaholi - ayenabaholi
wkakungcono - kwakungcono
basifilha - basifihla
yayolhasela - yayohlasela
aylesi - yalesi
baanikazi - abanikazi
ezidnala - ezindala
iziynembezi - izinyembezi
mininignwane - mininingwane
wayegnenalo - wayengenalo
iyasidna - iyasinda
ababebmeke - ababembeke
Akugaguwla - Akugagulwa
usehbala - usebhala
owadnulela - owandulela
elsilo - lesilo
ezidnawo - ezindawo
kahsayeki - kashayeki
sekuzohpela - sekuzophela
elehta - eletha
Kuhabmisana - Kuhambisana
gnezinsuku - ngezinsuku
ensalawo - nesalawo
selhukaniswa - sehlukaniswa
maanoveli - amanoveli
wlakhe - lwakhe
yeesibili - eyesibili
osekuhbalwe - osekubhalwe
izignxoxo - izingxoxo
lignachaza - lingachaza
ayihpume - ayiphume
sihbeka - sibheka
wlencwadi - lwencwadi
wafmaka - wamfaka
yeayaziwa - eyayaziwa
elokusebeznisa - elokusebenzisa
nevmelaphi - nemvelaphi
olkubuye - lokubuye
ezohkonza - ezokhonza
oveletnabeni - ovelentabeni
yeafa - eyafa
souke - osuke
uhmoli - umholi
bmono - mbono
faake - afake
wKathi - Kwathi
yayiwkenza - yayikwenza
okugnathiwa - okungathiwa
gnabawaziyo - ngabawaziyo
qaale - aqale
emahkaya - emakhaya
zeivelele - ezivelele
yeabe - eyabe
wKamanye - Kwamanye
oldule - odlule
nagnezindlela - nangezindlela
bacgina - bagcina
abbenamasoka - babenamasoka
yidniki - yindiki
yayiseyihbungu - yayiseyibhungu
kulhoswe - kuhloswe
Izidnuna - Izinduna
bahsesha - bashesha
nednodakazi - nendodakazi
enwele - newele
ognakumana - ongakumana
ebognela - ebongela
ziibalo - izibalo
gnaloku - ngaloku
wkacaca - kwacaca
yisihkathi - yisikhathi
egnowesithupha - engowesithupha
wokulugnisa - wokulungisa
awbuza - wabuza
izihnlamvu - izinhlamvu
esixgile - esigxile
gnalolu - ngalolu
bause - abuse
edNlunkulu - eNdlunkulu
ebsine - besine
imbiko - mibiko
negnxenye - nengxenye
qnubo - nqubo
yuaya - uyaya
iknosazane - inkosazane
seyeldulela - seyedlulela
uhkethe - ukhethe
jNengezincwadi - Njengezincwadi
yezneka - yenzeka
Abasednlunkulu - Abasendlunkulu
lokuqukehtwe - lokuqukethwe
isihpolile - isipholile
uksabusa - kusabusa
badigna - badinga
eyisihtupha - eyisithupha
owayehtanda - owayethanda
itnando - intando
kouyiqoqo - okuyiqoqo
Dignane - Dingane
wayohkulela - wayokhulela
babalekiwsa - babalekiswa
kuuganisela - ukuganisela
awyekade - wayekade
abanmyana - abamnyana
yahmlubuka - yamhlubuka
yokne - yonke
owkakuphilwa - okwakuphilwa
yalednlala - yalendlala
isibmulala - isimbulala
UMalimahti - UMalimathi
gnumbhali - ngumbhali
Abakihti - Abakithi
bawle - balwe
kuhkala - kukhala
gnodadewabo - ngodadewabo
ububmano - ubumbano
yiofana - iyofana
Kusahkulunywa - Kusakhulunywa
bAalobi - Abalobi
ezazinosmebenzi - ezazinomsebenzi
almotsholelwa - amlotsholelwa
wkakhiwe - kwakhiwe
kuqikelewle - kuqikelelwe
Isahkiwo - Isakhiwo
kaubona - akubona
nomuyne - nomunye
kouyizo - okuyizo
suebaqedile - usebaqedile
wowkeshwama - wokweshwama
gnayizolo - ngayizolo
natnathu - nantathu
wkezizwe - kwezizwe
nonmdlunkulu - nomndlunkulu
veulekile - evulekile
ohtathwa - othathwa
uyahsa - uyasha
olkuqala - lokuqala
lmungu - mlungu
uhkubazekile - ukhubazekile
gnemikhakha - ngemikhakha
ukulagnazelela - ukulangazelela
eyolda - eyodla
eqgamile - egqamile
babulignaniselwa - babulinganiselwa
maasiko - amasiko
Obuyne - Obunye
uzihbala - uzibhala
iqgabuke - igqabuke
Geoli - eGoli
gnokusethula - ngokusethula
doelelayo - odelelayo
eziynanyeni - ezinyanyeni
ziyayiladnela - ziyayilandela
okuhtinta - okuthinta
bulhale - buhlale
kucahsisa - kucashisa
ezaziqnotshwe - ezazinqotshwe
zayibabma - zayibamba
wkababeseduze - kwababeseduze
IkNosi - INkosi
nokmhulu - nomkhulu
aslo - salo
gnamathongo - ngamathongo
awayohteza - awayotheza
gnekhono - ngekhono
yameynelwa - yamenyelwa
gnabelungu - ngabelungu
yokuldulisa - yokudlulisa
wkedlinza - kwedlinza
ElikabMuyazi - ElikaMbuyazi
ahbekane - abhekane
nokuqodna - nokuqonda
oykuqala - yokuqala
asse - sase
yuena - uyena
nomutnu - nomuntu
bahqube - baqhube
baebuye - abebuye
awyesezala - wayesezala
esnimini - ensimini
agnabazi - angabazi
kaNodnela - kaNondela
esiladnelayo - esilandelayo
oluhpathelene - oluphathelene
ihnloso - inhloso
siiyaze - isiyaze
wlansondo - lwansondo
bazahka - bazakha
agnalichaza - angalichaza
siznonzo - sinzonzo
wkethula - kwethula
ziwze - zizwe
gnenkathi - ngenkathi
beusayo - ebusayo
seabulala - esabulala
awahbala - awabhala
abelhule - abehlule
ekNosi - eNkosi
kuhsintshwe - kushintshwe
esasugnulwa - esasungulwa
aszo - sazo
ukuhsayisana - ukushayisana
Agnebalwe - Angebalwe
wayohkonza - wayokhonza
eYurohpu - eYurophu
bewlela - belwela
ayyisuke - yayisuke
abatnwana - abantwana
ezignengaphansi - ezingengaphansi
wayehsesha - wayeshesha
ababebalewla - ababebalelwa
diolo - idolo
Kusezibognweni - Kusezibongweni
idnlela - indlela
Imihbalo - Imibhalo
zepmi - zempi
odigna - odinga
sahke - sakhe
ihpikise - iphikise
zokuhbala - zokubhala
zeimukile - ezimukile
uhKathi - uKhathi
kouwuyena - okuwuyena
isiwlane - isilwane
fiune - ifune
qiuma - iquma
ulhu - uhlu
kiomidi - ikomidi
abahkona - abakhona
osuhbaliwe - osubhaliwe
yabanmyama - yabamnyama
esbebona - sebebona
yahpendula - yaphendula
ucgine - ugcine
yabuyiwsa - yabuyiswa
amanigni - amaningi
Sekuzozohqathaniswa - Sekuzozoqhathaniswa
Idnodakazi - Indodakazi
iylabo - yilabo
ahpuma - aphuma
Huulumeni - uHulumeni
loumayelana - olumayelana
gniyilandelise - ngiyilandelise
Bavmeza - Bamveza
bewza - bezwa
wkindlela - kwindlela
ukliwa - kuliwa
esyicela - seyicela
sicgonwa - sigconwa
ihtolakala - itholakala
wehbuku - webhuku
bausisa - abusisa
elagneni - elangeni
jnani - njani
kuzovewza - kuzovezwa
yisihtabathaba - yisithabathaba
uhpawu - uphawu
azkudala - zakudala
ezahkayo - ezakhayo
kuhti - kuthi
kuucikoza - ukucikoza
agnakwenza - angakwenza
seesisele - esesisele
kokubewka - kokubekwa
kouyisona - okuyisona
nesihsiyagalolunye - nesishiyagalolunye
yisihkali - yisikhali
walhasela - wahlasela
yayihtola - yayithola
amahte - amathe
olkufa - lokufa
yokuhtola - yokuthola
baasusela - abasusela
zibezne - zibenze
nehti - nethi
yahtatha - yathatha
gnayithumela - ngayithumela
esehsiya - eseshiya
hKambi - Khambi
yowkakhisa - yokwakhisa
gNuye - Nguye
kuubuza - ukubuza
woabona - owabona
aYyimisa - Yayimisa
aNkuba - Nakuba
abaziqabmayo - abaziqambayo
ebsibulala - besibulala
nokulhakanipha - nokuhlakanipha
zizugneze - zizungeze
isihpumelelise - isiphumelelise
ihpovela - iphovela
ewzakalayo - ezwakalayo
olna - lona
kaukona - akukona
ulqale - luqale
gnemuva - ngemuva
ollu - lolu
eNbala - Nebala
mahBunu - maBhunu
gnobunyonico - ngobunyonico
gnxenye - ngxenye
ulfake - lufake
wawkaNtuli - wakwaNtuli
oklalele - kolalele
ezisesthenziswa - ezisetshenziswa
ezivewzayo - ezivezwayo
okkubili - kokubili
kaMahpoloba - kaMapholoba
wahso - washo
idnida - indida
yisiwza - yisizwa
sekuhkothama - sekukhothama
woaba - owaba
nowkethuka - nokwethuka
asfana - safana
imihtetho - imithetho
aWqala - Waqala
anmagama - namagama
namarehkodi - namarekhodi
okuhkolakala - okukholakala
eseknanjini - esenkanjini
bagnazitholi - bangazitholi
zihkala - zikhala
gnezibhamu - ngezibhamu
Kuhkombisa - Kukhombisa
yokulhala - yokuhlala
uldubu - udlubu
izbalulekile - zibalulekile
yiaqinisekisa - iyaqinisekisa
okugneyona - okungeyona
awkenza - akwenza
Muageba - uMageba
owkehlukile - okwehlukile
iziwzana - izizwana
esedmala - esemdala
olhale - ohlale
elibajnwa - elibanjwa
behtathelana - bethathelana
Ukuqowka - Ukuqokwa
ukmhonto - umkhonto
asbesifazane - sabesifazane
fuhti - futhi
kuuqikelelile - ukuqikelelile
ezihcaza - ezichaza
bayihkohliselani - bayikhohliselani
gnabezibuza - ngabezibuza
yobuhkosi - yobukhosi
zihabmisane - zihambisane
uhPakathwayo - uPhakathwayo
zamahkosi - zamakhosi
wawuhbala - wawubhala
esihtile - esithile
lahkeka - lakheka
ezosesthenziswa - ezosetshenziswa
okudignekayo - okudingekayo
iyisihtunywa - iyisithunywa
eyayisimelhule - eyayisimehlule
nohti - nothi
eyayihpatha - eyayiphatha
sehsuminanye - seshuminanye
ayyinamaculo - yayinamaculo
hsaka - shaka
kuyizignxenye - kuyizingxenye
qeokiwe - eqokiwe
ahbeke - abheke
yignoba - yingoba
jnengophawu - njengophawu
koumayelana - okumayelana
nemihbalo - nemibhalo
ewsiziba - wesiziba
owezniwa - owenziwa
ineqebmu - ineqembu